KEY_CODE,CITYNAME,NAME,T000848001,O000848001,T000848002,O000848002,T000848003,O000848003,T000848004
13101,千代田区,,58406,2091,29343,1174,29063,917,33262
131010010,千代田区,丸の内,8,X,7,X,1,X,8
13101001001,千代田区,丸の内１丁目,4,X,3,X,1,X,4
13101001002,千代田区,丸の内２丁目,1,X,1,X,0,X,1
13101001003,千代田区,丸の内３丁目,3,X,3,X,0,X,3
131010020,千代田区,大手町,5,X,5,X,0,X,5
13101002001,千代田区,大手町１丁目,3,X,3,X,0,X,3
13101002002,千代田区,大手町２丁目,2,X,2,X,0,X,2
131010030,千代田区,内幸町,4,X,3,X,1,X,3
13101003001,千代田区,内幸町１丁目,3,X,2,X,1,X,2
13101003002,千代田区,内幸町２丁目,1,X,1,X,0,X,1
131010040,千代田区,有楽町,22,4,16,4,6,0,18
13101004001,千代田区,有楽町１丁目,19,4,13,4,6,0,15
13101004002,千代田区,有楽町２丁目,3,X,3,X,0,X,3
131010050,千代田区,霞が関,4,X,3,X,1,X,4
13101005001,千代田区,霞が関１丁目,0,0,0,0,0,0,0
13101005002,千代田区,霞が関２丁目,2,X,2,X,0,X,2
13101005003,千代田区,霞が関３丁目,2,X,1,X,1,X,2
131010060,千代田区,永田町,526,103,313,66,213,37,349
13101006001,千代田区,永田町１丁目,12,X,11,X,1,X,9
13101006002,千代田区,永田町２丁目,514,103,302,66,212,37,340
131010070,千代田区,隼町,471,2,372,2,99,0,353
131010080,千代田区,平河町,1765,113,870,78,895,35,988
13101008001,千代田区,平河町１丁目,832,36,411,28,421,8,476
13101008002,千代田区,平河町２丁目,933,77,459,50,474,27,512
131010090,千代田区,麹町,2439,88,1170,53,1269,35,1253
13101009001,千代田区,麹町１丁目,695,24,328,14,367,10,361
13101009002,千代田区,麹町２丁目,627,38,298,27,329,11,330
13101009003,千代田区,麹町３丁目,307,7,152,1,155,6,170
13101009004,千代田区,麹町４丁目,605,6,290,4,315,2,284
13101009005,千代田区,麹町５丁目,127,10,56,4,71,6,75
13101009006,千代田区,麹町６丁目,78,3,46,3,32,0,33
131010100,千代田区,紀尾井町,308,42,204,39,104,3,189
131010110,千代田区,一番町,3522,101,1579,54,1943,47,1668
131010120,千代田区,皇居外苑,0,0,0,0,0,0,0
131010130,千代田区,日比谷公園,8,X,8,X,0,X,8
131010140,千代田区,千代田,98,0,82,0,16,0,97
131010150,千代田区,北の丸公園,726,0,444,0,282,0,384
131010160,千代田区,九段南,3020,64,1499,34,1521,30,1645
13101016001,千代田区,九段南１丁目,129,0,110,0,19,0,113
13101016002,千代田区,九段南２丁目,820,29,367,13,453,16,448
13101016003,千代田区,九段南３丁目,705,18,339,10,366,8,445
13101016004,千代田区,九段南４丁目,1366,17,683,11,683,6,639
131010170,千代田区,九段北,1865,71,936,39,929,32,1082
13101017001,千代田区,九段北１丁目,998,53,520,33,478,20,606
13101017002,千代田区,九段北２丁目,266,4,103,2,163,2,122
13101017003,千代田区,九段北３丁目,68,1,37,0,31,1,38
13101017004,千代田区,九段北４丁目,533,13,276,4,257,9,316
131010180,千代田区,富士見,4148,100,1873,45,2275,55,2140
13101018001,千代田区,富士見１丁目,949,22,456,14,493,8,453
13101018002,千代田区,富士見２丁目,3199,78,1417,31,1782,47,1687
131010190,千代田区,飯田橋,2626,87,1223,41,1403,46,1471
13101019001,千代田区,飯田橋１丁目,279,7,126,3,153,4,136
13101019002,千代田区,飯田橋２丁目,1492,56,688,24,804,32,858
13101019003,千代田区,飯田橋３丁目,396,14,184,9,212,5,191
13101019004,千代田区,飯田橋４丁目,459,10,225,5,234,5,286
131010200,千代田区,一ツ橋,57,3,36,3,21,0,44
13101020001,千代田区,一ツ橋１丁目,0,0,0,0,0,0,0
13101020002,千代田区,一ツ橋２丁目,57,3,36,3,21,0,44
131010210,千代田区,神田神保町,3009,72,1543,37,1466,35,1852
13101021001,千代田区,神田神保町１丁目,1390,31,707,12,683,19,804
13101021002,千代田区,神田神保町２丁目,990,16,518,11,472,5,662
13101021003,千代田区,神田神保町３丁目,629,25,318,14,311,11,386
131010220,千代田区,三崎町,953,30,465,16,488,14,573
13101022001,千代田区,三崎町１丁目,23,0,11,0,12,0,11
13101022002,千代田区,三崎町２丁目,497,21,237,12,260,9,251
13101022003,千代田区,三崎町３丁目,433,9,217,4,216,5,311
131010230,千代田区,西神田,1238,62,622,36,616,26,694
13101023001,千代田区,西神田１丁目,89,2,45,1,44,1,50
13101023002,千代田区,西神田２丁目,738,33,360,17,378,16,403
13101023003,千代田区,西神田３丁目,411,27,217,18,194,9,241
131010240,千代田区,猿楽町,787,10,423,5,364,5,465
13101024001,千代田区,猿楽町１丁目,249,5,120,3,129,2,107
13101024002,千代田区,猿楽町２丁目,538,5,303,2,235,3,358
131010250,千代田区,神田駿河台,772,13,339,8,433,5,615
13101025001,千代田区,神田駿河台１丁目,62,4,41,1,21,3,48
13101025002,千代田区,神田駿河台２丁目,390,4,123,3,267,1,332
13101025003,千代田区,神田駿河台３丁目,96,1,49,1,47,0,47
13101025004,千代田区,神田駿河台４丁目,224,4,126,3,98,1,188
131010260,千代田区,神田錦町,824,19,442,7,382,12,589
13101026001,千代田区,神田錦町１丁目,316,5,175,2,141,3,244
13101026002,千代田区,神田錦町２丁目,168,11,86,4,82,7,97
13101026003,千代田区,神田錦町３丁目,340,3,181,1,159,2,248
131010270,千代田区,神田小川町,1154,52,590,28,564,24,712
13101027001,千代田区,神田小川町１丁目,253,12,110,7,143,5,146
13101027002,千代田区,神田小川町２丁目,195,1,87,0,108,1,120
13101027003,千代田区,神田小川町３丁目,706,39,393,21,313,18,446
131010280,千代田区,神田美土代町,47,3,24,2,23,1,34
131010290,千代田区,内神田,1538,85,788,40,750,45,936
13101029001,千代田区,内神田１丁目,775,40,378,17,397,23,470
13101029002,千代田区,内神田２丁目,351,9,194,6,157,3,218
13101029003,千代田区,内神田３丁目,412,36,216,17,196,19,248
131010300,千代田区,神田司町,405,23,211,13,194,10,231
131010310,千代田区,神田多町,893,39,504,21,389,18,633
131010320,千代田区,神田淡路町,1207,25,576,14,631,11,671
13101032001,千代田区,神田淡路町１丁目,152,4,83,2,69,2,107
13101032002,千代田区,神田淡路町２丁目,1055,21,493,12,562,9,564
131010330,千代田区,神田須田町,1191,70,670,37,521,33,805
13101033001,千代田区,神田須田町１丁目,594,39,314,17,280,22,377
13101033002,千代田区,神田須田町２丁目,597,31,356,20,241,11,428
131010340,千代田区,外神田,3575,107,1917,72,1658,35,2045
13101034001,千代田区,外神田１丁目,183,0,113,0,70,0,126
13101034002,千代田区,外神田２丁目,897,8,455,6,442,2,546
13101034003,千代田区,外神田３丁目,579,15,305,9,274,6,299
13101034004,千代田区,外神田４丁目,872,31,475,18,397,13,486
13101034005,千代田区,外神田５丁目,333,16,167,8,166,8,177
13101034006,千代田区,外神田６丁目,711,37,402,31,309,6,411
131010350,千代田区,鍛冶町,263,4,138,2,125,2,142
13101035001,千代田区,鍛冶町１丁目,122,1,65,0,57,1,64
13101035002,千代田区,鍛冶町２丁目,141,3,73,2,68,1,78
131010360,千代田区,神田鍛冶町,120,1,57,0,63,1,69
131010370,千代田区,神田紺屋町,127,7,61,3,66,4,89
131010380,千代田区,神田北乗物町,55,2,29,1,26,1,29
131010390,千代田区,神田富山町,113,2,57,2,56,0,69
131010400,千代田区,神田美倉町,54,0,33,0,21,0,51
131010410,千代田区,岩本町,3039,182,1728,104,1311,78,2068
13101041001,千代田区,岩本町１丁目,931,57,485,30,446,27,560
13101041002,千代田区,岩本町２丁目,1459,88,811,53,648,35,980
13101041003,千代田区,岩本町３丁目,649,37,432,21,217,16,528
131010420,千代田区,神田西福田町,9,X,2,X,7,X,5
131010430,千代田区,神田東松下町,248,4,133,2,115,2,141
131010440,千代田区,神田東紺屋町,47,1,36,1,11,0,40
131010450,千代田区,神田岩本町,49,1,22,1,27,0,27
131010460,千代田区,東神田,2749,140,1518,74,1231,66,1822
13101046001,千代田区,東神田１丁目,1438,86,754,44,684,42,933
13101046002,千代田区,東神田２丁目,519,29,311,17,208,12,397
13101046003,千代田区,東神田３丁目,792,25,453,13,339,12,492
131010470,千代田区,神田和泉町,673,24,356,13,317,11,352
131010480,千代田区,神田佐久間町,1151,22,583,13,568,9,728
13101048001,千代田区,神田佐久間町１丁目,22,0,10,0,12,0,19
13101048002,千代田区,神田佐久間町２丁目,91,4,43,3,48,1,55
13101048003,千代田区,神田佐久間町３丁目,657,14,362,8,295,6,409
13101048004,千代田区,神田佐久間町４丁目,381,4,168,2,213,2,245
131010490,千代田区,神田平河町,12,0,6,0,6,0,4
131010500,千代田区,神田松永町,53,2,23,1,30,1,21
131010510,千代田区,神田花岡町,0,0,0,0,0,0,0
131010520,千代田区,神田佐久間河岸,119,39,68,23,51,16,98
131010530,千代田区,神田練塀町,291,6,159,3,132,3,174
131010540,千代田区,神田相生町,0,0,0,0,0,0,0
131010550,千代田区,二番町,1647,48,819,33,828,15,790
131010560,千代田区,三番町,3340,148,1544,72,1796,76,1626
131010570,千代田区,四番町,2543,41,1174,14,1369,27,1137
131010580,千代田区,五番町,1013,12,375,8,638,4,582
131010590,千代田区,六番町,1476,17,665,10,811,7,634
13102,中央区,,141183,4691,67536,2408,73647,2283,79272
131020010,中央区,八重洲,93,5,48,2,45,3,53
13102001001,中央区,八重洲１丁目,58,4,28,1,30,3,25
13102001002,中央区,八重洲２丁目,35,1,20,1,15,0,28
131020020,中央区,京橋,359,46,200,24,159,22,268
13102002001,中央区,京橋１丁目,94,7,49,4,45,3,75
13102002002,中央区,京橋２丁目,170,37,95,19,75,18,119
13102002003,中央区,京橋３丁目,95,2,56,1,39,1,74
131020030,中央区,銀座,3332,127,1552,64,1780,63,2215
13102003001,中央区,銀座１丁目,1495,35,661,17,834,18,897
13102003002,中央区,銀座２丁目,567,24,255,13,312,11,402
13102003003,中央区,銀座３丁目,235,6,99,1,136,5,162
13102003004,中央区,銀座４丁目,134,2,60,1,74,1,95
13102003005,中央区,銀座５丁目,45,6,23,2,22,4,28
13102003006,中央区,銀座６丁目,67,3,41,3,26,0,43
13102003007,中央区,銀座７丁目,254,28,134,18,120,10,179
13102003008,中央区,銀座８丁目,535,23,279,9,256,14,409
131020040,中央区,新富,1811,54,838,23,973,31,1116
13102004001,中央区,新富１丁目,1020,21,477,4,543,17,633
13102004002,中央区,新富２丁目,791,33,361,19,430,14,483
131020050,中央区,入船,2261,65,1071,30,1190,35,1478
13102005001,中央区,入船１丁目,850,28,385,14,465,14,532
13102005002,中央区,入船２丁目,697,15,354,6,343,9,505
13102005003,中央区,入船３丁目,714,22,332,10,382,12,441
131020060,中央区,湊,4788,146,2263,79,2525,67,2739
13102006001,中央区,湊１丁目,1011,28,495,15,516,13,582
13102006002,中央区,湊２丁目,952,31,464,18,488,13,554
13102006003,中央区,湊３丁目,2825,87,1304,46,1521,41,1603
131020070,中央区,明石町,3131,79,1325,41,1806,38,1826
131020080,中央区,築地,7971,235,3731,117,4240,118,5008
13102008001,中央区,築地１丁目,899,17,408,4,491,13,602
13102008002,中央区,築地２丁目,1155,34,586,14,569,20,786
13102008003,中央区,築地３丁目,778,24,338,7,440,17,537
13102008004,中央区,築地４丁目,636,57,338,43,298,14,444
13102008005,中央区,築地５丁目,391,4,136,3,255,1,333
13102008006,中央区,築地６丁目,1374,27,645,10,729,17,780
13102008007,中央区,築地７丁目,2738,72,1280,36,1458,36,1526
131020090,中央区,浜離宮庭園,4,X,2,X,2,X,2
131020100,中央区,八丁堀,3276,73,1637,34,1639,39,2088
13102010001,中央区,八丁堀１丁目,92,1,53,0,39,1,66
13102010002,中央区,八丁堀２丁目,995,16,497,6,498,10,635
13102010003,中央区,八丁堀３丁目,1130,29,566,13,564,16,732
13102010004,中央区,八丁堀４丁目,1059,27,521,15,538,12,655
131020110,中央区,新川,7040,379,3554,222,3486,157,4331
13102011001,中央区,新川１丁目,2919,187,1488,112,1431,75,1910
13102011002,中央区,新川２丁目,4121,192,2066,110,2055,82,2421
131020120,中央区,日本橋本石町,96,2,42,0,54,2,46
13102012001,中央区,日本橋本石町１丁目,0,0,0,0,0,0,0
13102012002,中央区,日本橋本石町２丁目,0,0,0,0,0,0,0
13102012003,中央区,日本橋本石町３丁目,4,X,1,X,3,X,2
13102012004,中央区,日本橋本石町４丁目,92,X,41,X,51,X,44
131020130,中央区,日本橋室町,268,25,133,16,135,9,155
13102013001,中央区,日本橋室町１丁目,156,9,71,7,85,2,91
13102013002,中央区,日本橋室町２丁目,53,2,28,1,25,1,33
13102013003,中央区,日本橋室町３丁目,5,X,4,X,1,X,2
13102013004,中央区,日本橋室町４丁目,54,14,30,8,24,6,29
131020140,中央区,日本橋本町,1013,23,521,10,492,13,726
13102014001,中央区,日本橋本町１丁目,211,5,118,3,93,2,146
13102014002,中央区,日本橋本町２丁目,185,2,84,0,101,2,123
13102014003,中央区,日本橋本町３丁目,138,7,82,3,56,4,122
13102014004,中央区,日本橋本町４丁目,479,9,237,4,242,5,335
131020150,中央区,日本橋小舟町,787,30,399,10,388,20,482
131020160,中央区,日本橋小伝馬町,917,98,457,75,460,23,516
131020170,中央区,日本橋大伝馬町,1389,23,718,9,671,14,835
131020180,中央区,日本橋堀留町,2209,53,1024,22,1185,31,1450
13102018001,中央区,日本橋堀留町１丁目,773,16,360,5,413,11,519
13102018002,中央区,日本橋堀留町２丁目,1436,37,664,17,772,20,931
131020190,中央区,日本橋富沢町,1018,30,485,15,533,15,655
131020200,中央区,日本橋人形町,4959,125,2249,54,2710,71,2837
13102020001,中央区,日本橋人形町１丁目,1487,36,708,24,779,12,841
13102020002,中央区,日本橋人形町２丁目,2589,51,1159,18,1430,33,1416
13102020003,中央区,日本橋人形町３丁目,883,38,382,12,501,26,580
131020210,中央区,日本橋小網町,1203,58,592,32,611,26,781
131020220,中央区,日本橋蛎殻町,4826,100,2220,44,2606,56,2990
13102022001,中央区,日本橋蛎殻町１丁目,3496,65,1621,31,1875,34,2101
13102022002,中央区,日本橋蛎殻町２丁目,1330,35,599,13,731,22,889
131020230,中央区,日本橋箱崎町,3598,178,1728,104,1870,74,2104
131020240,中央区,日本橋馬喰町,1457,70,727,43,730,27,1021
13102024001,中央区,日本橋馬喰町１丁目,904,60,457,38,447,22,619
13102024002,中央区,日本橋馬喰町２丁目,553,10,270,5,283,5,402
131020250,中央区,日本橋横山町,737,20,375,11,362,9,403
131020260,中央区,東日本橋,4805,148,2313,72,2492,76,2954
13102026001,中央区,東日本橋１丁目,939,13,431,3,508,10,611
13102026002,中央区,東日本橋２丁目,2221,85,1063,43,1158,42,1302
13102026003,中央区,東日本橋３丁目,1645,50,819,26,826,24,1041
131020270,中央区,日本橋久松町,622,11,307,5,315,6,365
131020280,中央区,日本橋浜町,9945,322,4596,152,5349,170,5686
13102028001,中央区,日本橋浜町１丁目,1768,98,804,40,964,58,1026
13102028002,中央区,日本橋浜町２丁目,4310,108,2007,49,2303,59,2461
13102028003,中央区,日本橋浜町３丁目,3867,116,1785,63,2082,53,2199
131020290,中央区,日本橋中洲,2392,45,1100,23,1292,22,1321
131020310,中央区,日本橋,246,12,120,5,126,7,174
13102031001,中央区,日本橋１丁目,58,0,29,0,29,0,43
13102031002,中央区,日本橋２丁目,49,7,25,5,24,2,37
13102031003,中央区,日本橋３丁目,139,5,66,0,73,5,94
131020320,中央区,日本橋茅場町,1065,29,508,12,557,17,674
13102032001,中央区,日本橋茅場町１丁目,57,3,24,1,33,2,39
13102032002,中央区,日本橋茅場町２丁目,358,8,186,3,172,5,229
13102032003,中央区,日本橋茅場町３丁目,650,18,298,8,352,10,406
131020330,中央区,日本橋兜町,676,30,374,16,302,14,538
131020340,中央区,佃,13650,525,6395,273,7255,252,6621
13102034001,中央区,佃１丁目,2658,151,1254,81,1404,70,1260
13102034002,中央区,佃２丁目,9372,340,4371,175,5001,165,4483
13102034003,中央区,佃３丁目,1620,34,770,17,850,17,878
131020350,中央区,月島,14890,362,7201,206,7689,156,8111
13102035001,中央区,月島１丁目,4625,109,2191,56,2434,53,2210
13102035002,中央区,月島２丁目,2550,94,1242,54,1308,40,1346
13102035003,中央区,月島３丁目,4299,107,2096,61,2203,46,2619
13102035004,中央区,月島４丁目,3416,52,1672,35,1744,17,1936
131020360,中央区,勝どき,23239,799,11307,398,11932,401,11696
13102036001,中央区,勝どき１丁目,4579,192,2219,93,2360,99,2357
13102036002,中央区,勝どき２丁目,2873,66,1507,34,1366,32,1720
13102036003,中央区,勝どき３丁目,3138,83,1458,42,1680,41,1589
13102036004,中央区,勝どき４丁目,1796,58,917,31,879,27,1080
13102036005,中央区,勝どき５丁目,3858,87,1825,34,2033,53,1877
13102036006,中央区,勝どき６丁目,6995,313,3381,164,3614,149,3073
131020370,中央区,豊海町,1521,24,816,9,705,15,729
131020380,中央区,晴海,9584,340,4603,156,4981,184,4273
13102038001,中央区,晴海１丁目,4054,113,1885,52,2169,61,1649
13102038002,中央区,晴海２丁目,2400,105,1170,46,1230,59,1030
13102038003,中央区,晴海３丁目,1341,42,679,22,662,20,730
13102038004,中央区,晴海４丁目,110,7,54,2,56,5,76
13102038005,中央区,晴海５丁目,1679,73,815,34,864,39,788
131020390,中央区,水面調査区,5,0,5,0,0,0,5
13103,港区,,243283,17118,114717,9106,128566,8012,130562
131030010,港区,芝,13343,687,6261,346,7082,341,7992
13103001001,港区,芝１丁目,1539,96,765,54,774,42,925
13103001002,港区,芝２丁目,3002,155,1444,87,1558,68,1737
13103001003,港区,芝３丁目,3452,203,1637,101,1815,102,2017
13103001004,港区,芝４丁目,2259,77,1064,41,1195,36,1313
13103001005,港区,芝５丁目,3091,156,1351,63,1740,93,2000
131030020,港区,海岸,6147,337,3379,192,2768,145,3822
13103002001,港区,海岸１丁目,2042,142,1072,81,970,61,1277
13103002002,港区,海岸２丁目,710,29,358,19,352,10,361
13103002003,港区,海岸３丁目,3395,166,1949,92,1446,74,2184
131030030,港区,東新橋,1811,67,872,40,939,27,993
13103003001,港区,東新橋１丁目,1410,40,651,21,759,19,719
13103003002,港区,東新橋２丁目,401,27,221,19,180,8,274
131030040,港区,新橋,2583,101,1353,65,1230,36,1622
13103004001,港区,新橋１丁目,15,0,8,0,7,0,13
13103004002,港区,新橋２丁目,129,0,54,0,75,0,89
13103004003,港区,新橋３丁目,231,1,124,1,107,0,118
13103004004,港区,新橋４丁目,463,19,248,12,215,7,306
13103004005,港区,新橋５丁目,682,46,363,31,319,15,452
13103004006,港区,新橋６丁目,1063,35,556,21,507,14,644
131030050,港区,西新橋,1442,77,727,42,715,35,972
13103005001,港区,西新橋１丁目,316,9,175,5,141,4,201
13103005002,港区,西新橋２丁目,391,21,203,12,188,9,245
13103005003,港区,西新橋３丁目,735,47,349,25,386,22,526
131030060,港区,三田,18503,802,8425,430,10078,372,9954
13103006001,港区,三田１丁目,4248,276,1968,150,2280,126,2355
13103006002,港区,三田２丁目,4025,203,1818,104,2207,99,2096
13103006003,港区,三田３丁目,1534,54,767,28,767,26,892
13103006004,港区,三田４丁目,3400,96,1517,51,1883,45,1781
13103006005,港区,三田５丁目,5296,173,2355,97,2941,76,2830
131030070,港区,浜松町,1843,123,962,72,881,51,1122
13103007001,港区,浜松町１丁目,1498,109,784,66,714,43,876
13103007002,港区,浜松町２丁目,345,14,178,6,167,8,246
131030080,港区,芝大門,1525,98,730,58,795,40,992
13103008001,港区,芝大門１丁目,677,28,321,20,356,8,427
13103008002,港区,芝大門２丁目,848,70,409,38,439,32,565
131030090,港区,芝公園,1188,73,592,45,596,28,791
13103009001,港区,芝公園１丁目,218,3,109,2,109,1,148
13103009002,港区,芝公園２丁目,631,57,310,37,321,20,452
13103009003,港区,芝公園３丁目,285,6,144,2,141,4,153
13103009004,港区,芝公園４丁目,54,7,29,4,25,3,38
131030100,港区,虎ノ門,3516,263,1689,155,1827,108,2043
13103010001,港区,虎ノ門１丁目,460,30,227,18,233,12,276
13103010002,港区,虎ノ門２丁目,100,1,60,1,40,0,29
13103010003,港区,虎ノ門３丁目,1814,124,911,74,903,50,1094
13103010004,港区,虎ノ門４丁目,662,80,259,44,403,36,412
13103010005,港区,虎ノ門５丁目,480,28,232,18,248,10,232
131030110,港区,愛宕,555,210,317,131,238,79,325
13103011001,港区,愛宕１丁目,43,4,26,4,17,0,24
13103011002,港区,愛宕２丁目,512,206,291,127,221,79,301
131030120,港区,麻布狸穴町,655,58,326,36,329,22,304
131030130,港区,麻布永坂町,222,40,99,24,123,16,91
131030140,港区,南麻布,15936,1732,7193,892,8743,840,8477
13103014001,港区,南麻布１丁目,3774,348,1739,170,2035,178,2131
13103014002,港区,南麻布２丁目,3701,267,1726,144,1975,123,2224
13103014003,港区,南麻布３丁目,2945,339,1353,176,1592,163,1600
13103014004,港区,南麻布４丁目,3288,468,1405,239,1883,229,1576
13103014005,港区,南麻布５丁目,2228,310,970,163,1258,147,946
131030150,港区,元麻布,4984,896,2402,469,2582,427,2311
13103015001,港区,元麻布１丁目,1183,140,534,72,649,68,540
13103015002,港区,元麻布２丁目,2168,428,1001,206,1167,222,911
13103015003,港区,元麻布３丁目,1633,328,867,191,766,137,860
131030160,港区,西麻布,10049,891,4682,463,5367,428,5218
13103016001,港区,西麻布１丁目,1488,98,733,51,755,47,912
13103016002,港区,西麻布２丁目,2488,176,1154,80,1334,96,1333
13103016003,港区,西麻布３丁目,3147,319,1452,163,1695,156,1550
13103016004,港区,西麻布４丁目,2926,298,1343,169,1583,129,1423
131030170,港区,六本木,11528,1917,5661,1063,5867,854,6437
13103017001,港区,六本木１丁目,2224,477,1046,268,1178,209,1127
13103017002,港区,六本木２丁目,559,100,286,40,273,60,446
13103017003,港区,六本木３丁目,2414,468,1243,254,1171,214,1501
13103017004,港区,六本木４丁目,986,132,504,79,482,53,516
13103017005,港区,六本木５丁目,1816,146,802,73,1014,73,902
13103017006,港区,六本木６丁目,1528,417,800,261,728,156,751
13103017007,港区,六本木７丁目,2001,177,980,88,1021,89,1194
131030180,港区,麻布台,2106,227,1018,122,1088,105,1264
13103018001,港区,麻布台１丁目,716,69,347,36,369,33,440
13103018002,港区,麻布台２丁目,415,52,198,31,217,21,247
13103018003,港区,麻布台３丁目,975,106,473,55,502,51,577
131030190,港区,麻布十番,6009,415,2748,201,3261,214,3878
13103019001,港区,麻布十番１丁目,1215,61,577,30,638,31,729
13103019002,港区,麻布十番２丁目,2679,219,1243,107,1436,112,1747
13103019003,港区,麻布十番３丁目,1707,111,769,55,938,56,1138
13103019004,港区,麻布十番４丁目,408,24,159,9,249,15,264
131030200,港区,東麻布,4805,417,2282,236,2523,181,3023
13103020001,港区,東麻布１丁目,1914,215,893,126,1021,89,1257
13103020002,港区,東麻布２丁目,2145,134,1059,81,1086,53,1264
13103020003,港区,東麻布３丁目,746,68,330,29,416,39,502
131030210,港区,元赤坂,623,35,303,16,320,19,356
13103021001,港区,元赤坂１丁目,322,35,147,16,175,19,199
13103021002,港区,元赤坂２丁目,301,0,156,0,145,0,157
131030220,港区,赤坂,17749,2052,8531,1087,9218,965,10136
13103022001,港区,赤坂１丁目,533,174,264,106,269,68,233
13103022002,港区,赤坂２丁目,3040,479,1518,234,1522,245,1906
13103022003,港区,赤坂３丁目,299,57,144,14,155,43,193
13103022004,港区,赤坂４丁目,2170,141,1047,83,1123,58,1211
13103022005,港区,赤坂５丁目,835,176,382,108,453,68,442
13103022006,港区,赤坂６丁目,3776,413,1827,213,1949,200,2199
13103022007,港区,赤坂７丁目,2441,196,1163,98,1278,98,1403
13103022008,港区,赤坂８丁目,3026,214,1332,123,1694,91,1436
13103022009,港区,赤坂９丁目,1629,202,854,108,775,94,1113
131030230,港区,南青山,14154,619,6501,361,7653,258,7219
13103023001,港区,南青山１丁目,2546,111,1159,67,1387,44,1349
13103023002,港区,南青山２丁目,1990,84,933,49,1057,35,1063
13103023003,港区,南青山３丁目,1140,48,531,25,609,23,607
13103023004,港区,南青山４丁目,3296,176,1542,111,1754,65,1618
13103023005,港区,南青山５丁目,1279,49,573,26,706,23,605
13103023006,港区,南青山６丁目,1754,64,812,36,942,28,962
13103023007,港区,南青山７丁目,2149,87,951,47,1198,40,1015
131030240,港区,北青山,3171,118,1260,59,1911,59,1665
13103024001,港区,北青山１丁目,1494,69,584,29,910,40,712
13103024002,港区,北青山２丁目,528,16,226,12,302,4,263
13103024003,港区,北青山３丁目,1149,33,450,18,699,15,690
131030250,港区,高輪,21943,786,10059,410,11884,376,11702
13103025001,港区,高輪１丁目,6985,290,3069,142,3916,148,3746
13103025002,港区,高輪２丁目,6305,173,2867,93,3438,80,3450
13103025003,港区,高輪３丁目,4609,138,2144,67,2465,71,2400
13103025004,港区,高輪４丁目,4044,185,1979,108,2065,77,2106
131030260,港区,白金,17449,875,7829,438,9620,437,9237
13103026001,港区,白金１丁目,4820,234,2131,102,2689,132,2655
13103026002,港区,白金２丁目,2292,151,1005,87,1287,64,1043
13103026003,港区,白金３丁目,3884,221,1767,104,2117,117,2186
13103026004,港区,白金４丁目,1379,64,597,38,782,26,649
13103026005,港区,白金５丁目,1636,66,757,32,879,34,964
13103026006,港区,白金６丁目,3438,139,1572,75,1866,64,1740
131030270,港区,白金台,11328,603,5016,308,6312,295,5676
13103027001,港区,白金台１丁目,1080,59,458,24,622,35,499
13103027002,港区,白金台２丁目,2688,116,1226,67,1462,49,1349
13103027003,港区,白金台３丁目,3668,130,1640,69,2028,61,1742
13103027004,港区,白金台４丁目,2049,211,890,104,1159,107,1145
13103027005,港区,白金台５丁目,1843,87,802,44,1041,43,941
131030280,港区,芝浦,22237,1358,11009,708,11228,650,11275
13103028001,港区,芝浦１丁目,1241,67,690,32,551,35,893
13103028002,港区,芝浦２丁目,3416,224,1642,122,1774,102,1978
13103028003,港区,芝浦３丁目,2035,171,991,89,1044,82,1126
13103028004,港区,芝浦４丁目,15545,896,7686,465,7859,431,7278
131030290,港区,港南,20398,876,9856,455,10542,421,9355
13103029001,港区,港南１丁目,247,15,118,8,129,7,125
13103029002,港区,港南２丁目,2582,111,1238,61,1344,50,1341
13103029003,港区,港南３丁目,6749,280,3255,131,3494,149,3022
13103029004,港区,港南４丁目,10295,442,4932,240,5363,202,4557
13103029005,港区,港南５丁目,525,28,313,15,212,13,310
131030300,港区,台場,5478,365,2632,182,2846,183,2307
13103030001,港区,台場１丁目,4537,338,2168,167,2369,171,1880
13103030002,港区,台場２丁目,941,27,464,15,477,12,427
131030310,港区,‐,3,X,3,X,0,X,3
13104,新宿区,,333560,30506,167258,15384,166302,15122,204989
131040010,新宿区,四谷,4358,227,2163,95,2195,132,2660
13104001001,新宿区,四谷１丁目,431,18,190,11,241,7,214
13104001002,新宿区,四谷２丁目,341,12,162,4,179,8,191
13104001003,新宿区,四谷３丁目,409,11,200,3,209,8,286
13104001004,新宿区,四谷４丁目,3177,186,1611,77,1566,109,1969
131040020,新宿区,本塩町,412,20,198,6,214,14,236
131040030,新宿区,三栄町,1652,56,782,28,870,28,912
131040040,新宿区,四谷坂町,2120,91,1052,42,1068,49,1359
131040050,新宿区,若葉,3891,152,1864,79,2027,73,2092
13104005001,新宿区,若葉１丁目,2303,99,1111,57,1192,42,1186
13104005002,新宿区,若葉２丁目,633,14,309,7,324,7,338
13104005003,新宿区,若葉３丁目,955,39,444,15,511,24,568
131040060,新宿区,須賀町,1371,32,698,18,673,14,785
131040070,新宿区,左門町,1485,59,670,30,815,29,947
131040080,新宿区,信濃町,849,17,391,10,458,7,477
131040090,新宿区,南元町,2268,117,1053,58,1215,59,1155
131040100,新宿区,荒木町,2100,118,1045,59,1055,59,1396
131040110,新宿区,舟町,1304,43,619,22,685,21,891
131040120,新宿区,愛住町,1263,50,612,26,651,24,787
131040130,新宿区,大京町,3391,105,1565,55,1826,50,2036
131040140,新宿区,霞ヶ丘町,212,0,81,0,131,0,129
131040150,新宿区,内藤町,1012,47,514,28,498,19,483
131040160,新宿区,片町,351,10,175,4,176,6,237
131040170,新宿区,新宿,18327,1751,9627,871,8700,880,12575
13104017001,新宿区,新宿１丁目,4280,326,2248,161,2032,165,3131
13104017002,新宿区,新宿２丁目,1186,65,639,32,547,33,837
13104017003,新宿区,新宿３丁目,129,7,81,3,48,4,76
13104017004,新宿区,新宿４丁目,334,6,208,2,126,4,249
13104017005,新宿区,新宿５丁目,2168,157,1185,77,983,80,1637
13104017006,新宿区,新宿６丁目,4012,439,2086,211,1926,228,2825
13104017007,新宿区,新宿７丁目,6218,751,3180,385,3038,366,3820
131040180,新宿区,歌舞伎町,2428,395,1460,152,968,243,1930
13104018001,新宿区,歌舞伎町１丁目,172,14,129,10,43,4,151
13104018002,新宿区,歌舞伎町２丁目,2256,381,1331,142,925,239,1779
131040190,新宿区,市谷田町,974,49,422,28,552,21,563
13104019001,新宿区,市谷田町１丁目,18,0,6,0,12,0,9
13104019002,新宿区,市谷田町２丁目,619,24,255,13,364,11,352
13104019003,新宿区,市谷田町３丁目,337,25,161,15,176,10,202
131040200,新宿区,市谷本村町,2676,94,1652,42,1024,52,1282
131040210,新宿区,市谷砂土原町,1629,193,770,104,859,89,826
13104021001,新宿区,市谷砂土原町１丁目,236,15,114,9,122,6,109
13104021002,新宿区,市谷砂土原町２丁目,430,22,196,13,234,9,256
13104021003,新宿区,市谷砂土原町３丁目,963,156,460,82,503,74,461
131040220,新宿区,市谷左内町,481,31,234,18,247,13,255
131040230,新宿区,市谷加賀町,2080,94,941,41,1139,53,911
13104023001,新宿区,市谷加賀町１丁目,332,1,159,0,173,1,113
13104023002,新宿区,市谷加賀町２丁目,1748,93,782,41,966,52,798
131040240,新宿区,市谷甲良町,635,16,299,5,336,11,344
131040250,新宿区,市谷船河原町,260,22,123,11,137,11,102
131040260,新宿区,市谷長延寺町,154,3,54,0,100,3,111
131040270,新宿区,市谷鷹匠町,48,0,22,0,26,0,22
131040280,新宿区,市谷山伏町,484,15,232,7,252,8,244
131040290,新宿区,市谷八幡町,112,2,48,1,64,1,54
131040300,新宿区,神楽坂,2454,56,1160,32,1294,24,1550
13104030001,新宿区,神楽坂１丁目,28,0,13,0,15,0,12
13104030002,新宿区,神楽坂２丁目,201,7,88,2,113,5,127
13104030003,新宿区,神楽坂３丁目,475,15,242,8,233,7,350
13104030004,新宿区,神楽坂４丁目,143,5,69,3,74,2,87
13104030005,新宿区,神楽坂５丁目,703,7,314,5,389,2,379
13104030006,新宿区,神楽坂６丁目,904,22,434,14,470,8,595
131040310,新宿区,細工町,457,10,219,3,238,7,259
131040320,新宿区,二十騎町,664,21,314,10,350,11,371
131040330,新宿区,揚場町,107,0,55,0,52,0,54
131040340,新宿区,津久戸町,122,3,57,3,65,0,88
131040350,新宿区,東五軒町,2213,70,1041,35,1172,35,1148
131040360,新宿区,西五軒町,1699,69,845,35,854,34,947
131040370,新宿区,赤城元町,436,4,210,3,226,1,252
131040380,新宿区,南榎町,1360,34,651,15,709,19,695
131040390,新宿区,袋町,665,12,315,4,350,8,385
131040400,新宿区,払方町,950,60,461,30,489,30,506
131040410,新宿区,南町,774,12,375,8,399,4,382
131040420,新宿区,北町,933,6,444,4,489,2,521
131040430,新宿区,納戸町,851,33,398,19,453,14,478
131040440,新宿区,南山伏町,770,19,438,11,332,8,465
131040450,新宿区,北山伏町,520,10,220,6,300,4,296
131040460,新宿区,白銀町,1381,32,609,17,772,15,746
131040470,新宿区,下宮比町,366,8,177,4,189,4,245
131040480,新宿区,矢来町,4634,107,2201,57,2433,50,2466
131040490,新宿区,若宮町,946,101,471,51,475,50,528
131040500,新宿区,岩戸町,687,17,323,7,364,10,458
131040510,新宿区,中町,519,19,250,8,269,11,266
131040520,新宿区,箪笥町,686,21,331,10,355,11,493
131040530,新宿区,横寺町,801,14,384,4,417,10,527
131040540,新宿区,筑土八幡町,1006,15,422,8,584,7,603
131040550,新宿区,新小川町,3234,66,1588,36,1646,30,1971
131040560,新宿区,神楽河岸,0,0,0,0,0,0,0
131040570,新宿区,市谷薬王寺町,3291,198,1601,97,1690,101,2105
131040580,新宿区,市谷柳町,1284,45,577,20,707,25,844
131040590,新宿区,市谷仲之町,2391,235,1180,124,1211,111,1262
131040600,新宿区,赤城下町,1268,35,633,18,635,17,773
131040610,新宿区,天神町,1045,33,497,19,548,14,660
131040620,新宿区,榎町,642,28,322,15,320,13,433
131040630,新宿区,東榎町,297,26,148,13,149,13,211
131040640,新宿区,早稲田町,1052,46,516,26,536,20,715
131040650,新宿区,早稲田南町,839,66,437,37,402,29,494
131040660,新宿区,馬場下町,467,17,242,10,225,7,298
131040670,新宿区,原町,4701,266,2221,132,2480,134,2614
13104067001,新宿区,原町１丁目,1458,70,704,32,754,38,842
13104067002,新宿区,原町２丁目,1361,53,641,26,720,27,676
13104067003,新宿区,原町３丁目,1882,143,876,74,1006,69,1096
131040680,新宿区,喜久井町,1953,76,1002,34,951,42,1124
131040690,新宿区,築地町,558,12,262,5,296,7,319
131040700,新宿区,弁天町,3380,163,1654,92,1726,71,1963
131040710,新宿区,中里町,707,9,333,5,374,4,342
131040720,新宿区,山吹町,3151,68,1537,31,1614,37,2105
131040730,新宿区,改代町,571,27,295,11,276,16,358
131040740,新宿区,水道町,895,29,431,10,464,19,575
131040750,新宿区,早稲田鶴巻町,5298,351,2693,163,2605,188,3415
131040760,新宿区,住吉町,2586,160,1238,82,1348,78,1626
131040770,新宿区,市谷台町,1301,103,643,46,658,57,775
131040780,新宿区,河田町,2905,752,1417,369,1488,383,1469
131040790,新宿区,若松町,5443,304,2623,136,2820,168,3279
131040800,新宿区,余丁町,3904,199,1911,96,1993,103,2263
131040810,新宿区,戸山,9480,570,4075,216,5405,354,5563
13104081001,新宿区,戸山１丁目,2590,126,1237,59,1353,67,1620
13104081002,新宿区,戸山２丁目,5940,367,2365,122,3575,245,3395
13104081003,新宿区,戸山３丁目,950,77,473,35,477,42,548
131040820,新宿区,富久町,5729,305,2958,144,2771,161,3071
131040830,新宿区,百人町,17668,3798,9145,2059,8523,1739,10930
13104083001,新宿区,百人町１丁目,4443,1495,2664,833,1779,662,3329
13104083002,新宿区,百人町２丁目,5004,1598,2751,876,2253,722,3559
13104083003,新宿区,百人町３丁目,5407,346,2540,177,2867,169,2529
13104083004,新宿区,百人町４丁目,2814,359,1190,173,1624,186,1513
131040840,新宿区,大久保,16925,4639,8792,2325,8133,2314,10928
13104084001,新宿区,大久保１丁目,4402,1703,2411,899,1991,804,3184
13104084002,新宿区,大久保２丁目,8442,2650,4421,1313,4021,1337,5736
13104084003,新宿区,大久保３丁目,4081,286,1960,113,2121,173,2008
131040850,新宿区,戸塚町,226,56,106,27,120,29,171
131040860,新宿区,西早稲田,18391,2027,9129,941,9262,1086,11490
13104086001,新宿区,西早稲田１丁目,5651,476,2671,207,2980,269,3668
13104086002,新宿区,西早稲田２丁目,5778,869,2923,377,2855,492,3783
13104086003,新宿区,西早稲田３丁目,6962,682,3535,357,3427,325,4039
131040870,新宿区,高田馬場,18096,2360,9568,1213,8528,1147,11888
13104087001,新宿区,高田馬場１丁目,3991,474,2079,230,1912,244,2583
13104087002,新宿区,高田馬場２丁目,1826,229,970,109,856,120,1227
13104087003,新宿区,高田馬場３丁目,5860,667,3186,359,2674,308,4079
13104087004,新宿区,高田馬場４丁目,6419,990,3333,515,3086,475,3999
131040880,新宿区,下落合,14805,1137,7078,609,7727,528,8655
13104088001,新宿区,下落合１丁目,2537,525,1310,288,1227,237,1736
13104088002,新宿区,下落合２丁目,3482,204,1696,100,1786,104,1882
13104088003,新宿区,下落合３丁目,4418,145,1969,74,2449,71,2552
13104088004,新宿区,下落合４丁目,4368,263,2103,147,2265,116,2485
131040890,新宿区,中落合,15462,746,7698,375,7764,371,8678
13104089001,新宿区,中落合１丁目,3430,222,1720,110,1710,112,2154
13104089002,新宿区,中落合２丁目,4968,275,2409,142,2559,133,2670
13104089003,新宿区,中落合３丁目,4040,104,1993,59,2047,45,2178
13104089004,新宿区,中落合４丁目,3024,145,1576,64,1448,81,1676
131040900,新宿区,上落合,14987,791,7603,404,7384,387,9584
13104090001,新宿区,上落合１丁目,5319,306,2678,154,2641,152,3199
13104090002,新宿区,上落合２丁目,4921,230,2526,112,2395,118,3138
13104090003,新宿区,上落合３丁目,4747,255,2399,138,2348,117,3247
131040910,新宿区,西落合,13699,428,6757,214,6942,214,7754
13104091001,新宿区,西落合１丁目,4295,130,2115,69,2180,61,2397
13104091002,新宿区,西落合２丁目,4234,159,2173,77,2061,82,2469
13104091003,新宿区,西落合３丁目,3049,59,1433,27,1616,32,1750
13104091004,新宿区,西落合４丁目,2121,80,1036,41,1085,39,1138
131040920,新宿区,中井,4655,242,2382,127,2273,115,2766
13104092001,新宿区,中井１丁目,1705,93,938,53,767,40,1195
13104092002,新宿区,中井２丁目,2950,149,1444,74,1506,75,1571
131040930,新宿区,北新宿,25165,3906,13201,2051,11964,1855,16318
13104093001,新宿区,北新宿１丁目,6719,1319,3565,699,3154,620,4731
13104093002,新宿区,北新宿２丁目,5310,471,2795,244,2515,227,3120
13104093003,新宿区,北新宿３丁目,7090,1234,3670,661,3420,573,4533
13104093004,新宿区,北新宿４丁目,6046,882,3171,447,2875,435,3934
131040940,新宿区,西新宿,20781,1625,11028,828,9753,797,14670
13104094001,新宿区,西新宿１丁目,111,1,88,0,23,1,94
13104094002,新宿区,西新宿２丁目,109,4,99,3,10,1,103
13104094003,新宿区,西新宿３丁目,1685,100,801,57,884,43,1188
13104094004,新宿区,西新宿４丁目,7121,387,3785,194,3336,193,4872
13104094005,新宿区,西新宿５丁目,2967,185,1575,100,1392,85,2171
13104094006,新宿区,西新宿６丁目,3398,509,1774,237,1624,272,2304
13104094007,新宿区,西新宿７丁目,2321,189,1345,110,976,79,1793
13104094008,新宿区,西新宿８丁目,3069,250,1561,127,1508,123,2145
13105,文京区,,219724,6634,105990,3233,113734,3401,120858
131050100,文京区,後楽,2359,274,1176,142,1183,132,1266
13105010001,文京区,後楽１丁目,759,203,375,111,384,92,289
13105010002,文京区,後楽２丁目,1600,71,801,31,799,40,977
131050110,文京区,春日,5789,167,2741,70,3048,97,3236
13105011001,文京区,春日１丁目,1641,46,724,13,917,33,1075
13105011002,文京区,春日２丁目,4148,121,2017,57,2131,64,2161
131050120,文京区,小石川,22640,447,10733,201,11907,246,11923
13105012001,文京区,小石川１丁目,3766,82,1747,36,2019,46,2067
13105012002,文京区,小石川２丁目,4133,85,1997,29,2136,56,2335
13105012003,文京区,小石川３丁目,5336,116,2587,56,2749,60,2576
13105012004,文京区,小石川４丁目,3494,56,1613,26,1881,30,1840
13105012005,文京区,小石川５丁目,5911,108,2789,54,3122,54,3105
131050130,文京区,白山,18738,395,9215,185,9523,210,10300
13105013001,文京区,白山１丁目,4924,97,2457,48,2467,49,2824
13105013002,文京区,白山２丁目,4365,100,2169,47,2196,53,2391
13105013003,文京区,白山３丁目,1031,33,510,23,521,10,524
13105013004,文京区,白山４丁目,4360,87,2093,38,2267,49,2249
13105013005,文京区,白山５丁目,4058,78,1986,29,2072,49,2312
131050140,文京区,千石,18312,500,8791,239,9521,261,9472
13105014001,文京区,千石１丁目,3898,60,1862,30,2036,30,1858
13105014002,文京区,千石２丁目,4450,90,2117,44,2333,46,2106
13105014003,文京区,千石３丁目,4286,100,2076,53,2210,47,2163
13105014004,文京区,千石４丁目,5678,250,2736,112,2942,138,3345
131050150,文京区,水道,5993,166,3014,73,2979,93,3584
13105015001,文京区,水道１丁目,2706,81,1341,38,1365,43,1479
13105015002,文京区,水道２丁目,3287,85,1673,35,1614,50,2105
131050160,文京区,小日向,7886,137,3809,82,4077,55,3828
13105016001,文京区,小日向１丁目,2322,22,1107,18,1215,4,1099
13105016002,文京区,小日向２丁目,2368,51,1156,30,1212,21,1034
13105016003,文京区,小日向３丁目,1286,32,624,16,662,16,648
13105016004,文京区,小日向４丁目,1910,32,922,18,988,14,1047
131050170,文京区,大塚,18913,581,8922,259,9991,322,10923
13105017001,文京区,大塚１丁目,1287,22,584,10,703,12,646
13105017002,文京区,大塚２丁目,2108,86,887,18,1221,68,1138
13105017003,文京区,大塚３丁目,3788,108,1786,44,2002,64,2400
13105017004,文京区,大塚４丁目,3269,112,1528,58,1741,54,1861
13105017005,文京区,大塚５丁目,4454,123,2105,51,2349,72,2506
13105017006,文京区,大塚６丁目,4007,130,2032,78,1975,52,2372
131050180,文京区,関口,6796,228,3201,107,3595,121,3936
13105018001,文京区,関口１丁目,4783,183,2247,85,2536,98,2900
13105018002,文京区,関口２丁目,1118,18,509,7,609,11,584
13105018003,文京区,関口３丁目,895,27,445,15,450,12,452
131050190,文京区,目白台,7311,260,3634,154,3677,106,3608
13105019001,文京区,目白台１丁目,2394,158,1341,101,1053,57,1049
13105019002,文京区,目白台２丁目,2228,38,1053,14,1175,24,1262
13105019003,文京区,目白台３丁目,2689,64,1240,39,1449,25,1297
131050200,文京区,音羽,6038,145,2722,66,3316,79,3596
13105020001,文京区,音羽１丁目,4252,108,1934,51,2318,57,2591
13105020002,文京区,音羽２丁目,1786,37,788,15,998,22,1005
131050210,文京区,本郷,21424,631,10314,314,11110,317,12882
13105021001,文京区,本郷１丁目,4381,77,2033,37,2348,40,2377
13105021002,文京区,本郷２丁目,3502,76,1707,37,1795,39,2282
13105021003,文京区,本郷３丁目,3390,135,1591,58,1799,77,2222
13105021004,文京区,本郷４丁目,3964,110,1917,56,2047,54,2183
13105021005,文京区,本郷５丁目,3489,138,1829,79,1660,59,2028
13105021006,文京区,本郷６丁目,2106,88,1070,44,1036,44,1282
13105021007,文京区,本郷７丁目,592,7,167,3,425,4,508
131050220,文京区,湯島,9341,348,4707,154,4634,194,6000
13105022001,文京区,湯島１丁目,838,15,396,10,442,5,607
13105022002,文京区,湯島２丁目,3009,81,1558,38,1451,43,1989
13105022003,文京区,湯島３丁目,3221,165,1606,59,1615,106,2152
13105022004,文京区,湯島４丁目,2273,87,1147,47,1126,40,1252
131050230,文京区,西片,5426,147,2728,74,2698,73,2797
13105023001,文京区,西片１丁目,2486,50,1235,30,1251,20,1271
13105023002,文京区,西片２丁目,2940,97,1493,44,1447,53,1526
131050240,文京区,向丘,7044,298,3495,177,3549,121,3710
13105024001,文京区,向丘１丁目,3485,216,1819,144,1666,72,1712
13105024002,文京区,向丘２丁目,3559,82,1676,33,1883,49,1998
131050250,文京区,弥生,2086,101,1047,58,1039,43,1136
13105025001,文京区,弥生１丁目,458,19,234,9,224,10,262
13105025002,文京区,弥生２丁目,1628,82,813,49,815,33,874
131050260,文京区,根津,6512,182,3046,98,3466,84,3789
13105026001,文京区,根津１丁目,2534,39,1130,19,1404,20,1435
13105026002,文京区,根津２丁目,3978,143,1916,79,2062,64,2354
131050270,文京区,千駄木,20476,737,9856,329,10620,408,10932
13105027001,文京区,千駄木１丁目,1510,42,714,16,796,26,708
13105027002,文京区,千駄木２丁目,4501,137,2133,59,2368,78,2653
13105027003,文京区,千駄木３丁目,6724,323,3229,135,3495,188,3747
13105027004,文京区,千駄木４丁目,3059,119,1531,64,1528,55,1649
13105027005,文京区,千駄木５丁目,4682,116,2249,55,2433,61,2175
131050280,文京区,本駒込,26640,890,12839,451,13801,439,13940
13105028001,文京区,本駒込１丁目,4657,81,2228,35,2429,46,2481
13105028002,文京区,本駒込２丁目,5076,220,2499,138,2577,82,2554
13105028003,文京区,本駒込３丁目,3368,91,1629,41,1739,50,1872
13105028004,文京区,本駒込４丁目,4196,142,2042,72,2154,70,2166
13105028005,文京区,本駒込５丁目,5814,267,2803,122,3011,145,3063
13105028006,文京区,本駒込６丁目,3529,89,1638,43,1891,46,1804
13106,台東区,,198073,13795,101982,6887,96091,6908,112117
131060010,台東区,台東,8742,1058,4630,573,4112,485,5097
13106001001,台東区,台東１丁目,2149,147,1215,85,934,62,1252
13106001002,台東区,台東２丁目,2125,241,1109,126,1016,115,1240
13106001003,台東区,台東３丁目,2736,407,1384,211,1352,196,1571
13106001004,台東区,台東４丁目,1732,263,922,151,810,112,1034
131060020,台東区,秋葉原,122,14,85,13,37,1,110
131060030,台東区,東上野,8427,872,4276,462,4151,410,4801
13106003001,台東区,東上野１丁目,1304,209,709,132,595,77,833
13106003002,台東区,東上野２丁目,824,202,441,121,383,81,543
13106003003,台東区,東上野３丁目,1571,148,748,68,823,80,913
13106003004,台東区,東上野４丁目,1040,68,565,35,475,33,634
13106003005,台東区,東上野５丁目,1615,82,791,38,824,44,805
13106003006,台東区,東上野６丁目,2073,163,1022,68,1051,95,1073
131060040,台東区,上野,3752,510,1991,283,1761,227,2306
13106004001,台東区,上野１丁目,673,64,314,35,359,29,400
13106004002,台東区,上野２丁目,174,45,91,26,83,19,114
13106004003,台東区,上野３丁目,703,99,400,62,303,37,439
13106004004,台東区,上野４丁目,50,9,26,4,24,5,31
13106004005,台東区,上野５丁目,689,146,401,96,288,50,477
13106004006,台東区,上野６丁目,287,64,159,35,128,29,169
13106004007,台東区,上野７丁目,1176,83,600,25,576,58,676
131060050,台東区,池之端,5404,383,2662,199,2742,184,3039
13106005001,台東区,池之端１丁目,673,35,326,15,347,20,350
13106005002,台東区,池之端２丁目,2712,263,1348,132,1364,131,1605
13106005003,台東区,池之端３丁目,524,24,264,13,260,11,296
13106005004,台東区,池之端４丁目,1495,61,724,39,771,22,788
131060060,台東区,上野公園,306,11,215,6,91,5,108
131060070,台東区,北上野,4139,420,2187,195,1952,225,2460
13106007001,台東区,北上野１丁目,1186,100,642,44,544,56,700
13106007002,台東区,北上野２丁目,2953,320,1545,151,1408,169,1760
131060080,台東区,下谷,7408,626,3570,296,3838,330,4148
13106008001,台東区,下谷１丁目,2009,172,1003,71,1006,101,1086
13106008002,台東区,下谷２丁目,3315,248,1557,119,1758,129,1839
13106008003,台東区,下谷３丁目,2084,206,1010,106,1074,100,1223
131060090,台東区,入谷,6120,288,2984,134,3136,154,3443
13106009001,台東区,入谷１丁目,3320,133,1610,59,1710,74,1876
13106009002,台東区,入谷２丁目,2737,155,1344,75,1393,80,1536
13106009004,台東区,入谷４丁目,63,0,30,0,33,0,31
131060100,台東区,根岸,13246,1373,6561,647,6685,726,7329
13106010001,台東区,根岸１丁目,1193,197,606,89,587,108,724
13106010002,台東区,根岸２丁目,2083,368,1091,173,992,195,1402
13106010003,台東区,根岸３丁目,3288,401,1610,196,1678,205,1839
13106010004,台東区,根岸４丁目,2738,221,1373,126,1365,95,1403
13106010005,台東区,根岸５丁目,3944,186,1881,63,2063,123,1961
131060110,台東区,竜泉,8263,541,4173,282,4090,259,4367
13106011001,台東区,竜泉１丁目,2266,145,1172,83,1094,62,1281
13106011002,台東区,竜泉２丁目,2882,246,1413,124,1469,122,1380
13106011003,台東区,竜泉３丁目,3115,150,1588,75,1527,75,1706
131060120,台東区,三ノ輪,3075,191,1559,97,1516,94,1819
13106012001,台東区,三ノ輪１丁目,2231,145,1104,77,1127,68,1311
13106012002,台東区,三ノ輪２丁目,844,46,455,20,389,26,508
131060130,台東区,上野桜木,2370,72,1111,30,1259,42,1188
13106013001,台東区,上野桜木１丁目,1405,26,640,8,765,18,709
13106013002,台東区,上野桜木２丁目,965,46,471,22,494,24,479
131060140,台東区,谷中,8483,301,4162,175,4321,126,4609
13106014001,台東区,谷中１丁目,791,23,384,13,407,10,411
13106014002,台東区,谷中２丁目,1836,113,910,75,926,38,1031
13106014003,台東区,谷中３丁目,2971,84,1438,43,1533,41,1626
13106014004,台東区,谷中４丁目,572,6,308,3,264,3,288
13106014005,台東区,谷中５丁目,897,42,427,22,470,20,516
13106014006,台東区,谷中６丁目,363,6,172,0,191,6,173
13106014007,台東区,谷中７丁目,1053,27,523,19,530,8,564
131060150,台東区,柳橋,3131,267,1552,138,1579,129,1935
13106015001,台東区,柳橋１丁目,1186,82,613,60,573,22,705
13106015002,台東区,柳橋２丁目,1945,185,939,78,1006,107,1230
131060160,台東区,浅草橋,7441,814,3932,452,3509,362,4460
13106016001,台東区,浅草橋１丁目,1268,139,662,67,606,72,837
13106016002,台東区,浅草橋２丁目,1637,190,838,112,799,78,933
13106016003,台東区,浅草橋３丁目,1795,227,931,132,864,95,1044
13106016004,台東区,浅草橋４丁目,826,93,428,48,398,45,490
13106016005,台東区,浅草橋５丁目,1915,165,1073,93,842,72,1156
131060170,台東区,鳥越,2992,316,1545,166,1447,150,1639
13106017001,台東区,鳥越１丁目,1690,163,882,94,808,69,915
13106017002,台東区,鳥越２丁目,1302,153,663,72,639,81,724
131060180,台東区,蔵前,6079,440,3065,230,3014,210,3661
13106018001,台東区,蔵前１丁目,549,46,280,27,269,19,346
13106018002,台東区,蔵前２丁目,1545,97,777,47,768,50,899
13106018003,台東区,蔵前３丁目,1310,66,657,28,653,38,794
13106018004,台東区,蔵前４丁目,2675,231,1351,128,1324,103,1622
131060190,台東区,小島,3651,444,1886,243,1765,201,2150
13106019001,台東区,小島１丁目,2015,221,1019,119,996,102,1204
13106019002,台東区,小島２丁目,1636,223,867,124,769,99,946
131060200,台東区,三筋,4234,414,2171,210,2063,204,2363
13106020001,台東区,三筋１丁目,2281,219,1149,115,1132,104,1272
13106020002,台東区,三筋２丁目,1953,195,1022,95,931,100,1091
131060210,台東区,寿,5714,240,2794,110,2920,130,3105
13106021001,台東区,寿１丁目,1752,55,866,30,886,25,924
13106021002,台東区,寿２丁目,720,49,367,23,353,26,407
13106021003,台東区,寿３丁目,2343,116,1155,50,1188,66,1327
13106021004,台東区,寿４丁目,899,20,406,7,493,13,447
131060220,台東区,駒形,2316,189,1173,87,1143,102,1480
13106022001,台東区,駒形１丁目,1445,128,724,60,721,68,931
13106022002,台東区,駒形２丁目,871,61,449,27,422,34,549
131060230,台東区,元浅草,6863,425,3475,207,3388,218,3771
13106023001,台東区,元浅草１丁目,2138,120,1110,59,1028,61,1179
13106023002,台東区,元浅草２丁目,860,77,440,38,420,39,516
13106023003,台東区,元浅草３丁目,2218,139,1124,63,1094,76,1249
13106023004,台東区,元浅草４丁目,1647,89,801,47,846,42,827
131060240,台東区,松が谷,8029,425,4146,200,3883,225,4411
13106024001,台東区,松が谷１丁目,1092,108,589,69,503,39,583
13106024002,台東区,松が谷２丁目,2273,70,1141,25,1132,45,1223
13106024003,台東区,松が谷３丁目,2278,92,1221,37,1057,55,1278
13106024004,台東区,松が谷４丁目,2386,155,1195,69,1191,86,1327
131060250,台東区,西浅草,8091,616,4099,318,3992,298,4577
13106025001,台東区,西浅草１丁目,1018,58,500,34,518,24,628
13106025002,台東区,西浅草２丁目,2619,306,1366,162,1253,144,1652
13106025003,台東区,西浅草３丁目,4454,252,2233,122,2221,130,2297
131060260,台東区,雷門,2890,79,1399,31,1491,48,1616
13106026001,台東区,雷門１丁目,1363,48,646,20,717,28,744
13106026002,台東区,雷門２丁目,1527,31,753,11,774,20,872
131060270,台東区,花川戸,2462,87,1229,42,1233,45,1324
13106027001,台東区,花川戸１丁目,1121,37,564,18,557,19,610
13106027002,台東区,花川戸２丁目,1341,50,665,24,676,26,714
131060280,台東区,浅草,18326,857,9090,381,9236,476,10049
13106028001,台東区,浅草１丁目,1493,34,717,13,776,21,810
13106028002,台東区,浅草２丁目,2819,237,1410,106,1409,131,1630
13106028003,台東区,浅草３丁目,2898,106,1406,55,1492,51,1666
13106028004,台東区,浅草４丁目,2762,137,1368,52,1394,85,1466
13106028005,台東区,浅草５丁目,4565,215,2313,98,2252,117,2411
13106028006,台東区,浅草６丁目,3018,90,1499,38,1519,52,1608
13106028007,台東区,浅草７丁目,771,38,377,19,394,19,458
131060290,台東区,千束,10916,601,5889,277,5027,324,6464
13106029001,台東区,千束１丁目,1928,125,997,51,931,74,1094
13106029002,台東区,千束２丁目,2113,117,1068,57,1045,60,1213
13106029003,台東区,千束３丁目,3807,195,2045,97,1762,98,2202
13106029004,台東区,千束４丁目,3068,164,1779,72,1289,92,1955
131060300,台東区,東浅草,3129,128,1683,58,1446,70,1605
13106030001,台東区,東浅草１丁目,1547,63,810,26,737,37,790
13106030002,台東区,東浅草２丁目,1582,65,873,32,709,33,815
131060310,台東区,日本堤,6005,266,3722,124,2283,142,3912
13106031001,台東区,日本堤１丁目,2832,104,1939,57,893,47,1968
13106031002,台東区,日本堤２丁目,3173,162,1783,67,1390,95,1944
131060320,台東区,今戸,4343,132,2264,56,2079,76,2335
13106032001,台東区,今戸１丁目,1400,40,688,16,712,24,801
13106032002,台東区,今戸２丁目,2943,92,1576,40,1367,52,1534
131060330,台東区,清川,5703,162,3730,72,1973,90,3689
13106033001,台東区,清川１丁目,1997,58,1119,26,878,32,1061
13106033002,台東区,清川２丁目,3706,104,2611,46,1095,58,2628
131060340,台東区,橋場,5901,233,2972,93,2929,140,2747
13106034001,台東区,橋場１丁目,3655,107,1909,48,1746,59,1680
13106034002,台東区,橋場２丁目,2246,126,1063,45,1183,81,1067
13107,墨田区,,256274,8624,127925,3494,128349,5130,130862
131070010,墨田区,両国,6797,360,3394,159,3403,201,4055
13107001001,墨田区,両国１丁目,1343,84,656,39,687,45,750
13107001002,墨田区,両国２丁目,1996,124,1012,51,984,73,1169
13107001003,墨田区,両国３丁目,1657,60,796,26,861,34,1028
13107001004,墨田区,両国４丁目,1801,92,930,43,871,49,1108
131070020,墨田区,千歳,4441,130,2314,52,2127,78,2602
13107002001,墨田区,千歳１丁目,1456,39,728,19,728,20,816
13107002002,墨田区,千歳２丁目,1052,32,624,13,428,19,646
13107002003,墨田区,千歳３丁目,1933,59,962,20,971,39,1140
131070030,墨田区,緑,12086,507,6235,214,5851,293,6679
13107003001,墨田区,緑１丁目,2755,101,1444,48,1311,53,1592
13107003002,墨田区,緑２丁目,3167,89,1557,35,1610,54,1589
13107003003,墨田区,緑３丁目,2296,102,1184,44,1112,58,1231
13107003004,墨田区,緑４丁目,3868,215,2050,87,1818,128,2267
131070040,墨田区,立川,5282,151,2692,72,2590,79,3109
13107004001,墨田区,立川１丁目,1151,27,580,10,571,17,704
13107004002,墨田区,立川２丁目,1265,30,628,16,637,14,720
13107004003,墨田区,立川３丁目,1460,39,734,21,726,18,805
13107004004,墨田区,立川４丁目,1406,55,750,25,656,30,880
131070050,墨田区,菊川,7246,162,3557,59,3689,103,3911
13107005001,墨田区,菊川１丁目,1513,25,737,6,776,19,783
13107005002,墨田区,菊川２丁目,2125,42,1039,15,1086,27,1182
13107005003,墨田区,菊川３丁目,3608,95,1781,38,1827,57,1946
131070060,墨田区,江東橋,9776,1039,4905,379,4871,660,5739
13107006001,墨田区,江東橋１丁目,1420,175,705,60,715,115,857
13107006002,墨田区,江東橋２丁目,2189,196,1153,72,1036,124,1283
13107006003,墨田区,江東橋３丁目,674,125,375,59,299,66,500
13107006004,墨田区,江東橋４丁目,2460,442,1186,156,1274,286,1547
13107006005,墨田区,江東橋５丁目,3033,101,1486,32,1547,69,1552
131070070,墨田区,横網,1539,35,736,17,803,18,718
13107007001,墨田区,横網１丁目,282,7,148,5,134,2,128
13107007002,墨田区,横網２丁目,1257,28,588,12,669,16,590
131070080,墨田区,亀沢,8032,274,4026,109,4006,165,4084
13107008001,墨田区,亀沢１丁目,1953,68,999,27,954,41,1051
13107008002,墨田区,亀沢２丁目,1655,45,796,26,859,19,830
13107008003,墨田区,亀沢３丁目,1873,53,962,19,911,34,883
13107008004,墨田区,亀沢４丁目,2551,108,1269,37,1282,71,1320
131070090,墨田区,石原,9998,328,5126,140,4872,188,5354
13107009001,墨田区,石原１丁目,2539,127,1271,56,1268,71,1455
13107009002,墨田区,石原２丁目,2329,51,1163,21,1166,30,1180
13107009003,墨田区,石原３丁目,2622,78,1398,38,1224,40,1442
13107009004,墨田区,石原４丁目,2508,72,1294,25,1214,47,1277
131070100,墨田区,本所,8358,245,4200,89,4158,156,4220
13107010001,墨田区,本所１丁目,2815,97,1424,38,1391,59,1430
13107010002,墨田区,本所２丁目,1569,43,762,14,807,29,771
13107010003,墨田区,本所３丁目,1738,55,870,20,868,35,892
13107010004,墨田区,本所４丁目,2236,50,1144,17,1092,33,1127
131070110,墨田区,東駒形,6391,139,3215,63,3176,76,3512
13107011001,墨田区,東駒形１丁目,1211,33,609,18,602,15,714
13107011002,墨田区,東駒形２丁目,1436,23,705,10,731,13,722
13107011003,墨田区,東駒形３丁目,1377,28,688,11,689,17,767
13107011004,墨田区,東駒形４丁目,2367,55,1213,24,1154,31,1309
131070120,墨田区,吾妻橋,4958,102,2427,51,2531,51,2774
13107012001,墨田区,吾妻橋１丁目,2000,47,974,25,1026,22,1161
13107012002,墨田区,吾妻橋２丁目,1342,17,680,5,662,12,812
13107012003,墨田区,吾妻橋３丁目,1616,38,773,21,843,17,801
131070130,墨田区,錦糸,5071,574,2590,230,2481,344,3049
13107013001,墨田区,錦糸１丁目,1993,186,1032,77,961,109,1292
13107013002,墨田区,錦糸２丁目,680,135,365,65,315,70,419
13107013003,墨田区,錦糸３丁目,699,99,353,32,346,67,435
13107013004,墨田区,錦糸４丁目,1699,154,840,56,859,98,903
131070140,墨田区,太平,10630,715,5331,282,5299,433,5650
13107014001,墨田区,太平１丁目,3400,212,1723,86,1677,126,1722
13107014002,墨田区,太平２丁目,1463,156,783,66,680,90,897
13107014003,墨田区,太平３丁目,1062,67,530,25,532,42,616
13107014004,墨田区,太平４丁目,4705,280,2295,105,2410,175,2415
131070150,墨田区,横川,8025,340,4027,136,3998,204,4103
13107015001,墨田区,横川１丁目,1466,68,782,35,684,33,684
13107015002,墨田区,横川２丁目,1413,47,764,22,649,25,835
13107015003,墨田区,横川３丁目,1126,54,588,19,538,35,616
13107015004,墨田区,横川４丁目,1264,68,664,26,600,42,679
13107015005,墨田区,横川５丁目,2756,103,1229,34,1527,69,1289
131070160,墨田区,業平,9601,209,4698,89,4903,120,5041
13107016001,墨田区,業平１丁目,2841,35,1351,14,1490,21,1358
13107016002,墨田区,業平２丁目,1303,43,674,23,629,20,714
13107016003,墨田区,業平３丁目,1360,30,689,14,671,16,827
13107016004,墨田区,業平４丁目,1917,62,947,25,970,37,1088
13107016005,墨田区,業平５丁目,2180,39,1037,13,1143,26,1054
131070170,墨田区,向島,14796,238,7457,106,7339,132,7806
13107017001,墨田区,向島１丁目,2093,43,1094,25,999,18,1176
13107017002,墨田区,向島２丁目,2453,39,1201,19,1252,20,1305
13107017003,墨田区,向島３丁目,3850,61,1942,22,1908,39,2038
13107017004,墨田区,向島４丁目,2540,34,1257,18,1283,16,1184
13107017005,墨田区,向島５丁目,3860,61,1963,22,1897,39,2103
131070180,墨田区,東向島,22959,370,11286,139,11673,231,11385
13107018001,墨田区,東向島１丁目,2926,45,1473,17,1453,28,1500
13107018002,墨田区,東向島２丁目,4809,82,2319,34,2490,48,2475
13107018003,墨田区,東向島３丁目,3225,53,1577,22,1648,31,1463
13107018004,墨田区,東向島４丁目,3326,75,1628,27,1698,48,1719
13107018005,墨田区,東向島５丁目,3622,58,1762,22,1860,36,1811
13107018006,墨田区,東向島６丁目,5051,57,2527,17,2524,40,2417
131070190,墨田区,堤通,6799,249,3235,96,3564,153,3110
13107019001,墨田区,堤通１丁目,2370,65,1239,35,1131,30,1060
13107019002,墨田区,堤通２丁目,4429,184,1996,61,2433,123,2050
131070200,墨田区,墨田,17417,327,8672,130,8745,197,8012
13107020001,墨田区,墨田１丁目,2921,78,1405,34,1516,44,1172
13107020002,墨田区,墨田２丁目,3673,74,1862,25,1811,49,1707
13107020003,墨田区,墨田３丁目,3443,62,1762,28,1681,34,1613
13107020004,墨田区,墨田４丁目,4653,78,2250,30,2403,48,2162
13107020005,墨田区,墨田５丁目,2727,35,1393,13,1334,22,1358
131070210,墨田区,押上,9897,211,4928,86,4969,125,5032
13107021001,墨田区,押上１丁目,2153,49,1054,18,1099,31,1205
13107021002,墨田区,押上２丁目,3820,76,1842,31,1978,45,1895
13107021003,墨田区,押上３丁目,3924,86,2032,37,1892,49,1932
131070220,墨田区,京島,12218,232,6088,94,6130,138,5980
13107022001,墨田区,京島１丁目,6265,134,3036,51,3229,83,2996
13107022002,墨田区,京島２丁目,1764,34,917,17,847,17,897
13107022003,墨田区,京島３丁目,4189,64,2135,26,2054,38,2087
131070230,墨田区,文花,10537,329,4974,123,5563,206,4856
13107023001,墨田区,文花１丁目,5682,199,2575,78,3107,121,2716
13107023002,墨田区,文花２丁目,2159,66,1067,17,1092,49,1059
13107023003,墨田区,文花３丁目,2696,64,1332,28,1364,36,1081
131070240,墨田区,八広,21152,423,10748,157,10404,266,9825
13107024001,墨田区,八広１丁目,3259,49,1688,20,1571,29,1591
13107024002,墨田区,八広２丁目,3950,81,2009,30,1941,51,1786
13107024003,墨田区,八広３丁目,3374,71,1693,26,1681,45,1591
13107024004,墨田区,八広４丁目,3876,77,1987,24,1889,53,1773
13107024005,墨田区,八広５丁目,2887,79,1458,30,1429,49,1392
13107024006,墨田区,八広６丁目,3806,66,1913,27,1893,39,1692
131070250,墨田区,立花,20139,865,9955,383,10184,482,9335
13107025001,墨田区,立花１丁目,6209,331,3014,155,3195,176,3014
13107025002,墨田区,立花２丁目,1450,47,737,23,713,24,759
13107025003,墨田区,立花３丁目,2676,101,1321,47,1355,54,1303
13107025004,墨田区,立花４丁目,3578,129,1810,48,1768,81,1631
13107025005,墨田区,立花５丁目,3845,172,1945,79,1900,93,1616
13107025006,墨田区,立花６丁目,2381,85,1128,31,1253,54,1012
131070260,墨田区,東墨田,2129,70,1109,39,1020,31,921
13107026001,墨田区,東墨田１丁目,132,3,74,1,58,2,64
13107026002,墨田区,東墨田２丁目,1264,45,648,26,616,19,528
13107026003,墨田区,東墨田３丁目,733,22,387,12,346,10,329
13108,江東区,,498109,21373,246750,9891,251359,11482,243708
131080010,江東区,清澄,3362,59,1716,28,1646,31,1756
13108001001,江東区,清澄１丁目,1100,21,545,9,555,12,600
13108001002,江東区,清澄２丁目,1269,28,662,14,607,14,619
13108001003,江東区,清澄３丁目,993,10,509,5,484,5,537
131080020,江東区,常盤,1936,31,984,12,952,19,1159
13108002001,江東区,常盤１丁目,783,13,390,7,393,6,456
13108002002,江東区,常盤２丁目,1153,18,594,5,559,13,703
131080030,江東区,新大橋,5402,118,2622,58,2780,60,3070
13108003001,江東区,新大橋１丁目,1890,46,889,21,1001,25,1051
13108003002,江東区,新大橋２丁目,2102,53,1073,29,1029,24,1111
13108003003,江東区,新大橋３丁目,1410,19,660,8,750,11,908
131080040,江東区,森下,9984,167,5080,71,4904,96,5680
13108004001,江東区,森下１丁目,1285,24,628,11,657,13,719
13108004002,江東区,森下２丁目,1751,21,895,6,856,15,1069
13108004003,江東区,森下３丁目,3464,65,1791,28,1673,37,1992
13108004004,江東区,森下４丁目,2165,38,1071,20,1094,18,1192
13108004005,江東区,森下５丁目,1319,19,695,6,624,13,708
131080050,江東区,平野,6304,128,3195,58,3109,70,3230
13108005001,江東区,平野１丁目,1273,23,619,11,654,12,658
13108005002,江東区,平野２丁目,2609,39,1318,13,1291,26,1335
13108005003,江東区,平野３丁目,1803,51,904,26,899,25,822
13108005004,江東区,平野４丁目,619,15,354,8,265,7,415
131080060,江東区,三好,4933,57,2402,33,2531,24,2465
13108006001,江東区,三好１丁目,503,10,244,5,259,5,239
13108006002,江東区,三好２丁目,893,2,453,2,440,0,438
13108006003,江東区,三好３丁目,1660,18,797,12,863,6,850
13108006004,江東区,三好４丁目,1877,27,908,14,969,13,938
131080070,江東区,白河,11390,208,5465,105,5925,103,5302
13108007001,江東区,白河１丁目,1589,22,736,9,853,13,786
13108007002,江東区,白河２丁目,2478,28,1180,15,1298,13,1179
13108007003,江東区,白河３丁目,3143,48,1546,23,1597,25,1501
13108007004,江東区,白河４丁目,4180,110,2003,58,2177,52,1836
131080080,江東区,高橋,1449,24,707,6,742,18,888
131080090,江東区,佐賀,1912,88,1042,58,870,30,1173
13108009001,江東区,佐賀１丁目,1042,68,590,47,452,21,669
13108009002,江東区,佐賀２丁目,870,20,452,11,418,9,504
131080100,江東区,永代,3336,83,1677,39,1659,44,2079
13108010001,江東区,永代１丁目,1097,33,550,13,547,20,683
13108010002,江東区,永代２丁目,2239,50,1127,26,1112,24,1396
131080110,江東区,福住,2248,66,1157,29,1091,37,1222
13108011001,江東区,福住１丁目,1110,42,607,18,503,24,703
13108011002,江東区,福住２丁目,1138,24,550,11,588,13,519
131080120,江東区,深川,3952,79,1932,39,2020,40,2344
13108012001,江東区,深川１丁目,1582,33,754,13,828,20,906
13108012002,江東区,深川２丁目,2370,46,1178,26,1192,20,1438
131080130,江東区,冬木,2815,61,1440,36,1375,25,1521
131080140,江東区,門前仲町,2111,44,1077,21,1034,23,1340
13108014001,江東区,門前仲町１丁目,1594,29,797,12,797,17,993
13108014002,江東区,門前仲町２丁目,517,15,280,9,237,6,347
131080150,江東区,富岡,4015,88,2089,39,1926,49,2644
13108015001,江東区,富岡１丁目,2027,32,1019,13,1008,19,1293
13108015002,江東区,富岡２丁目,1988,56,1070,26,918,30,1351
131080160,江東区,牡丹,3376,71,1674,21,1702,50,1956
13108016001,江東区,牡丹１丁目,725,13,384,4,341,9,447
13108016002,江東区,牡丹２丁目,801,24,370,4,431,20,500
13108016003,江東区,牡丹３丁目,1850,34,920,13,930,21,1009
131080170,江東区,古石場,5076,71,2576,33,2500,38,2242
13108017001,江東区,古石場１丁目,1398,15,692,8,706,7,616
13108017002,江東区,古石場２丁目,2381,47,1224,22,1157,25,1050
13108017003,江東区,古石場３丁目,1297,9,660,3,637,6,576
131080180,江東区,越中島,6516,147,3305,74,3211,73,2830
13108018001,江東区,越中島１丁目,2317,58,1122,26,1195,32,1027
13108018002,江東区,越中島２丁目,1275,50,737,32,538,18,516
13108018003,江東区,越中島３丁目,2924,39,1446,16,1478,23,1287
131080190,江東区,塩浜,18565,904,9263,432,9302,472,7754
13108019001,江東区,塩浜１丁目,6456,175,3163,91,3293,84,2593
13108019002,江東区,塩浜２丁目,12109,729,6100,341,6009,388,5161
131080200,江東区,枝川,9934,627,4925,288,5009,339,4613
13108020001,江東区,枝川１丁目,4902,439,2426,207,2476,232,2330
13108020002,江東区,枝川２丁目,2343,68,1178,29,1165,39,1088
13108020003,江東区,枝川３丁目,2689,120,1321,52,1368,68,1195
131080210,江東区,豊洲,33195,1443,15935,694,17260,749,14286
13108021001,江東区,豊洲１丁目,4049,120,1898,64,2151,56,1868
13108021002,江東区,豊洲２丁目,3671,183,1768,90,1903,93,1520
13108021003,江東区,豊洲３丁目,7877,478,3883,232,3994,246,3444
13108021004,江東区,豊洲４丁目,11310,370,5394,176,5916,194,4711
13108021005,江東区,豊洲５丁目,3652,109,1677,42,1975,67,1627
13108021006,江東区,豊洲６丁目,2636,183,1315,90,1321,93,1116
131080220,江東区,東雲,23351,1155,11681,549,11670,606,10491
13108022001,江東区,東雲１丁目,17513,895,8868,431,8645,464,7999
13108022002,江東区,東雲２丁目,5838,260,2813,118,3025,142,2492
131080230,江東区,有明,8871,560,4445,263,4426,297,4113
13108023001,江東区,有明１丁目,8823,559,4438,263,4385,296,4068
13108023002,江東区,有明２丁目,0,0,0,0,0,0,0
13108023003,江東区,有明３丁目,48,1,7,0,41,1,45
13108023004,江東区,有明４丁目,0,0,0,0,0,0,0
131080240,江東区,辰巳,11648,784,5571,349,6077,435,5675
13108024001,江東区,辰巳１丁目,9670,701,4520,316,5150,385,4802
13108024002,江東区,辰巳２丁目,1945,83,1024,33,921,50,848
13108024003,江東区,辰巳３丁目,33,0,27,0,6,0,25
131080250,江東区,潮見,6111,230,3094,96,3017,134,2829
13108025001,江東区,潮見１丁目,2569,147,1296,61,1273,86,1050
13108025002,江東区,潮見２丁目,3542,83,1798,35,1744,48,1779
131080260,江東区,青海,1035,777,583,420,452,357,232
13108026001,江東区,青海１丁目,0,0,0,0,0,0,0
13108026002,江東区,青海２丁目,1035,777,583,420,452,357,232
13108026003,江東区,青海３丁目,0,0,0,0,0,0,0
13108026004,江東区,青海４丁目,0,0,0,0,0,0,0
131080270,江東区,千石,6879,129,3477,56,3402,73,3213
13108027001,江東区,千石１丁目,2548,64,1383,33,1165,31,1278
13108027002,江東区,千石２丁目,1767,34,839,11,928,23,895
13108027003,江東区,千石３丁目,2564,31,1255,12,1309,19,1040
131080280,江東区,石島,1336,32,693,19,643,13,654
131080290,江東区,千田,1850,54,882,21,968,33,921
131080300,江東区,海辺,1598,43,820,19,778,24,789
131080310,江東区,扇橋,7439,166,3702,83,3737,83,3697
13108031001,江東区,扇橋１丁目,2614,61,1314,35,1300,26,1170
13108031002,江東区,扇橋２丁目,1893,31,947,15,946,16,1055
13108031003,江東区,扇橋３丁目,2932,74,1441,33,1491,41,1472
131080320,江東区,猿江,5711,118,2877,54,2834,64,2740
13108032001,江東区,猿江１丁目,2943,75,1520,38,1423,37,1504
13108032002,江東区,猿江２丁目,2768,43,1357,16,1411,27,1236
131080330,江東区,住吉,4786,106,2384,45,2402,61,2653
13108033001,江東区,住吉１丁目,2465,44,1197,19,1268,25,1296
13108033002,江東区,住吉２丁目,2321,62,1187,26,1134,36,1357
131080340,江東区,毛利,3354,189,1740,83,1614,106,2042
13108034001,江東区,毛利１丁目,2338,101,1233,42,1105,59,1421
13108034002,江東区,毛利２丁目,1016,88,507,41,509,47,621
131080350,江東区,木場,10356,409,5157,198,5199,211,5686
13108035001,江東区,木場１丁目,178,3,89,1,89,2,82
13108035002,江東区,木場２丁目,2182,108,1157,57,1025,51,1274
13108035003,江東区,木場３丁目,3422,116,1727,52,1695,64,1660
13108035004,江東区,木場４丁目,0,0,0,0,0,0,0
13108035005,江東区,木場５丁目,1759,66,827,35,932,31,1109
13108035006,江東区,木場６丁目,2815,116,1357,53,1458,63,1561
131080360,江東区,東陽,23039,691,11316,338,11723,353,12452
13108036001,江東区,東陽１丁目,4415,166,2305,77,2110,89,2662
13108036002,江東区,東陽２丁目,4345,106,1963,48,2382,58,2007
13108036003,江東区,東陽３丁目,3051,96,1561,47,1490,49,1848
13108036004,江東区,東陽４丁目,3945,103,1838,52,2107,51,2094
13108036005,江東区,東陽５丁目,4009,99,1986,57,2023,42,2260
13108036006,江東区,東陽６丁目,2012,78,1040,39,972,39,992
13108036007,江東区,東陽７丁目,1262,43,623,18,639,25,589
131080370,江東区,亀戸,57502,3466,28896,1430,28606,2036,29834
13108037001,江東区,亀戸１丁目,5594,419,2812,156,2782,263,2973
13108037002,江東区,亀戸２丁目,6875,742,3313,316,3562,426,3939
13108037003,江東区,亀戸３丁目,8050,353,4093,137,3957,216,4189
13108037004,江東区,亀戸４丁目,3970,226,2018,88,1952,138,2337
13108037005,江東区,亀戸５丁目,5633,301,2937,135,2696,166,3238
13108037006,江東区,亀戸６丁目,5738,387,2798,153,2940,234,3315
13108037007,江東区,亀戸７丁目,8651,521,4406,212,4245,309,4472
13108037008,江東区,亀戸８丁目,2152,66,1101,30,1051,36,1089
13108037009,江東区,亀戸９丁目,10839,451,5418,203,5421,248,4282
131080380,江東区,大島,61687,3791,30035,1817,31652,1974,30608
13108038001,江東区,大島１丁目,7108,244,3464,109,3644,135,3424
13108038002,江東区,大島２丁目,5250,148,2618,62,2632,86,2732
13108038003,江東区,大島３丁目,5159,244,2475,103,2684,141,2331
13108038004,江東区,大島４丁目,8123,1231,4020,632,4103,599,4461
13108038005,江東区,大島５丁目,6591,186,3125,79,3466,107,3542
13108038006,江東区,大島６丁目,9585,1120,4688,564,4897,556,4695
13108038007,江東区,大島７丁目,7968,353,3954,161,4014,192,3895
13108038008,江東区,大島８丁目,8315,202,4098,79,4217,123,3978
13108038009,江東区,大島９丁目,3588,63,1593,28,1995,35,1550
131080390,江東区,北砂,37058,1700,18670,763,18388,937,17798
13108039001,江東区,北砂１丁目,4962,189,2578,81,2384,108,2477
13108039002,江東区,北砂２丁目,3095,114,1518,49,1577,65,1303
13108039003,江東区,北砂３丁目,7618,198,3781,82,3837,116,3419
13108039004,江東区,北砂４丁目,5221,119,2616,52,2605,67,2556
13108039005,江東区,北砂５丁目,9462,891,4835,432,4627,459,4769
13108039006,江東区,北砂６丁目,3594,43,1782,15,1812,28,1703
13108039007,江東区,北砂７丁目,3106,146,1560,52,1546,94,1571
131080400,江東区,東砂,35563,836,17555,358,18008,478,15748
13108040001,江東区,東砂１丁目,5043,72,2474,23,2569,49,2010
13108040002,江東区,東砂２丁目,5697,228,2698,117,2999,111,3112
13108040003,江東区,東砂３丁目,5525,150,2771,57,2754,93,2311
13108040004,江東区,東砂４丁目,4036,85,1997,34,2039,51,1426
13108040005,江東区,東砂５丁目,2283,50,1200,29,1083,21,1086
13108040006,江東区,東砂６丁目,2780,33,1427,12,1353,21,1190
13108040007,江東区,東砂７丁目,5720,132,2785,51,2935,81,2720
13108040008,江東区,東砂８丁目,4479,86,2203,35,2276,51,1893
131080410,江東区,南砂,40573,1439,19633,691,20940,748,19331
13108041001,江東区,南砂１丁目,7124,149,3523,75,3601,74,2968
13108041002,江東区,南砂２丁目,14861,778,7180,369,7681,409,7097
13108041003,江東区,南砂３丁目,4315,126,1985,57,2330,69,2228
13108041004,江東区,南砂４丁目,4073,92,1961,41,2112,51,2077
13108041005,江東区,南砂５丁目,4813,158,2346,80,2467,78,2480
13108041006,江東区,南砂６丁目,3100,92,1514,47,1586,45,1417
13108041007,江東区,南砂７丁目,2287,44,1124,22,1163,22,1064
131080420,江東区,新砂,6506,131,3241,62,3265,69,2610
13108042001,江東区,新砂１丁目,957,22,582,12,375,10,511
13108042002,江東区,新砂２丁目,452,22,223,11,229,11,175
13108042003,江東区,新砂３丁目,5097,87,2436,39,2661,48,1924
131080430,江東区,新木場,43,3,33,3,10,0,36
13108043001,江東区,新木場１丁目,5,X,4,X,1,X,4
13108043002,江東区,新木場２丁目,12,3,8,3,4,0,8
13108043003,江東区,新木場３丁目,26,0,21,0,5,0,24
13108043004,江東区,新木場４丁目,0,0,0,0,0,0,0
131080440,江東区,夢の島,0,0,0,0,0,0,0
13108044001,江東区,夢の島１丁目,0,0,0,0,0,0,0
13108044002,江東区,夢の島２丁目,0,0,0,0,0,0,0
13108044003,江東区,夢の島３丁目,0,0,0,0,0,0,0
131080450,江東区,若洲,0,0,0,0,0,0,0
13108045001,江東区,若洲１丁目,0,0,0,0,0,0,0
13108045002,江東区,若洲２丁目,0,0,0,0,0,0,0
13108045003,江東区,若洲３丁目,0,0,0,0,0,0,0
131080460,江東区,有明,2,X,2,X,0,X,2
13109,品川区,,386855,9259,191090,4493,195765,4766,212374
131090010,品川区,荏原,21275,269,10283,118,10992,151,11563
13109001001,品川区,荏原１丁目,2858,33,1456,23,1402,10,1671
13109001002,品川区,荏原２丁目,3181,52,1452,20,1729,32,1572
13109001003,品川区,荏原３丁目,2610,34,1246,10,1364,24,1576
13109001004,品川区,荏原４丁目,3796,44,1831,20,1965,24,2068
13109001005,品川区,荏原５丁目,2634,35,1307,17,1327,18,1459
13109001006,品川区,荏原６丁目,3471,45,1687,15,1784,30,1859
13109001007,品川区,荏原７丁目,2725,26,1304,13,1421,13,1358
131090020,品川区,大井,26705,551,13388,247,13317,304,14566
13109002001,品川区,大井１丁目,4057,109,2001,41,2056,68,2560
13109002002,品川区,大井２丁目,2772,56,1412,24,1360,32,1671
13109002003,品川区,大井３丁目,5289,108,2570,48,2719,60,2605
13109002004,品川区,大井４丁目,4197,99,2188,48,2009,51,2586
13109002005,品川区,大井５丁目,4106,55,2100,23,2006,32,2107
13109002006,品川区,大井６丁目,2889,48,1423,27,1466,21,1372
13109002007,品川区,大井７丁目,3395,76,1694,36,1701,40,1665
131090030,品川区,大崎,14668,442,7183,210,7485,232,7977
13109003001,品川区,大崎１丁目,2525,58,1198,28,1327,30,1415
13109003002,品川区,大崎２丁目,4083,116,1971,47,2112,69,2049
13109003003,品川区,大崎３丁目,3272,87,1671,46,1601,41,1828
13109003004,品川区,大崎４丁目,2313,51,1182,20,1131,31,1323
13109003005,品川区,大崎５丁目,2475,130,1161,69,1314,61,1362
131090040,品川区,勝島,2610,30,1537,11,1073,19,1152
13109004001,品川区,勝島１丁目,2400,29,1367,11,1033,18,991
13109004002,品川区,勝島２丁目,210,1,170,0,40,1,161
13109004003,品川区,勝島３丁目,0,0,0,0,0,0,0
131090050,品川区,上大崎,11603,496,5417,280,6186,216,6531
13109005001,品川区,上大崎１丁目,3233,98,1516,58,1717,40,1704
13109005002,品川区,上大崎２丁目,3812,211,1779,121,2033,90,2200
13109005003,品川区,上大崎３丁目,3091,105,1476,62,1615,43,1802
13109005004,品川区,上大崎４丁目,1467,82,646,39,821,43,825
131090060,品川区,北品川,19031,556,9312,292,9719,264,10340
13109006001,品川区,北品川１丁目,3624,79,1791,35,1833,44,2384
13109006002,品川区,北品川２丁目,3336,72,1690,36,1646,36,1884
13109006003,品川区,北品川３丁目,3515,74,1764,44,1751,30,1866
13109006004,品川区,北品川４丁目,1460,52,716,31,744,21,731
13109006005,品川区,北品川５丁目,6320,224,2971,113,3349,111,3067
13109006006,品川区,北品川６丁目,776,55,380,33,396,22,408
131090070,品川区,小山,19589,393,9335,195,10254,198,11122
13109007001,品川区,小山１丁目,2200,44,1121,22,1079,22,1225
13109007002,品川区,小山２丁目,3202,69,1530,33,1672,36,1707
13109007003,品川区,小山３丁目,3103,48,1431,22,1672,26,1775
13109007004,品川区,小山４丁目,2806,37,1287,18,1519,19,1647
13109007005,品川区,小山５丁目,2892,57,1379,30,1513,27,1628
13109007006,品川区,小山６丁目,4069,109,1984,53,2085,56,2517
13109007007,品川区,小山７丁目,1317,29,603,17,714,12,623
131090080,品川区,小山台,5685,79,2778,46,2907,33,3131
13109008001,品川区,小山台１丁目,4855,75,2376,44,2479,31,2734
13109008002,品川区,小山台２丁目,830,4,402,2,428,2,397
131090090,品川区,戸越,17260,311,8516,142,8744,169,9795
13109009001,品川区,戸越１丁目,4051,57,2049,18,2002,39,2466
13109009002,品川区,戸越２丁目,2167,35,1073,17,1094,18,1218
13109009003,品川区,戸越３丁目,2367,52,1135,25,1232,27,1348
13109009004,品川区,戸越４丁目,1988,36,969,12,1019,24,1084
13109009005,品川区,戸越５丁目,3293,57,1619,30,1674,27,1912
13109009006,品川区,戸越６丁目,3394,74,1671,40,1723,34,1767
131090100,品川区,中延,15543,184,7483,87,8060,97,8759
13109010001,品川区,中延１丁目,2215,27,1064,16,1151,11,1156
13109010002,品川区,中延２丁目,2480,20,1153,8,1327,12,1372
13109010003,品川区,中延３丁目,1796,11,891,5,905,6,1019
13109010004,品川区,中延４丁目,3291,32,1625,17,1666,15,1925
13109010005,品川区,中延５丁目,2642,40,1247,18,1395,22,1554
13109010006,品川区,中延６丁目,3119,54,1503,23,1616,31,1733
131090110,品川区,西大井,19214,308,9561,123,9653,185,9473
13109011001,品川区,西大井１丁目,2769,43,1398,18,1371,25,1336
13109011002,品川区,西大井２丁目,3438,58,1650,21,1788,37,1686
13109011003,品川区,西大井３丁目,2285,38,1196,16,1089,22,1070
13109011004,品川区,西大井４丁目,3346,48,1663,25,1683,23,1634
13109011005,品川区,西大井５丁目,4330,64,2136,24,2194,40,2059
13109011006,品川区,西大井６丁目,3046,57,1518,19,1528,38,1688
131090120,品川区,西五反田,25215,883,12381,450,12834,433,15277
13109012001,品川区,西五反田１丁目,820,42,417,21,403,21,595
13109012002,品川区,西五反田２丁目,2071,120,1045,44,1026,76,1478
13109012003,品川区,西五反田３丁目,5665,250,2702,128,2963,122,3172
13109012004,品川区,西五反田４丁目,4772,88,2309,50,2463,38,2660
13109012005,品川区,西五反田５丁目,5038,128,2464,71,2574,57,2942
13109012006,品川区,西五反田６丁目,3213,66,1655,31,1558,35,1971
13109012007,品川区,西五反田７丁目,1064,31,531,15,533,16,746
13109012008,品川区,西五反田８丁目,2572,158,1258,90,1314,68,1713
131090130,品川区,西品川,10618,250,5365,112,5253,138,5559
13109013001,品川区,西品川１丁目,3504,62,1765,28,1739,34,1690
13109013002,品川区,西品川２丁目,4067,104,2061,49,2006,55,2180
13109013003,品川区,西品川３丁目,3047,84,1539,35,1508,49,1689
131090140,品川区,西中延,7386,104,3678,50,3708,54,3953
13109014001,品川区,西中延１丁目,2205,27,1113,15,1092,12,1202
13109014002,品川区,西中延２丁目,2933,45,1458,21,1475,24,1576
13109014003,品川区,西中延３丁目,2248,32,1107,14,1141,18,1175
131090150,品川区,旗の台,16269,254,7789,119,8480,135,9160
13109015001,品川区,旗の台１丁目,1066,19,527,7,539,12,608
13109015002,品川区,旗の台２丁目,3063,64,1421,33,1642,31,1869
13109015003,品川区,旗の台３丁目,1653,20,820,11,833,9,1005
13109015004,品川区,旗の台４丁目,2678,46,1346,22,1332,24,1623
13109015005,品川区,旗の台５丁目,3933,51,1895,19,2038,32,2098
13109015006,品川区,旗の台６丁目,3876,54,1780,27,2096,27,1957
131090160,品川区,東大井,22938,535,11828,247,11110,288,12836
13109016001,品川区,東大井１丁目,5204,105,2672,42,2532,63,2571
13109016002,品川区,東大井２丁目,4353,75,2299,29,2054,46,2390
13109016003,品川区,東大井３丁目,4908,142,2534,65,2374,77,2828
13109016004,品川区,東大井４丁目,2635,59,1348,30,1287,29,1422
13109016005,品川区,東大井５丁目,4080,98,2027,51,2053,47,2516
13109016006,品川区,東大井６丁目,1758,56,948,30,810,26,1109
131090170,品川区,東五反田,15077,536,7191,256,7886,280,8581
13109017001,品川区,東五反田１丁目,2664,94,1307,44,1357,50,1734
13109017002,品川区,東五反田２丁目,4585,172,2159,80,2426,92,2410
13109017003,品川区,東五反田３丁目,2108,51,1046,31,1062,20,1179
13109017004,品川区,東五反田４丁目,2409,70,1184,35,1225,35,1385
13109017005,品川区,東五反田５丁目,3311,149,1495,66,1816,83,1873
131090180,品川区,東品川,20197,612,9959,319,10238,293,9987
13109018001,品川区,東品川１丁目,4060,133,2105,81,1955,52,2310
13109018002,品川区,東品川２丁目,1612,87,728,49,884,38,997
13109018003,品川区,東品川３丁目,10701,256,5232,121,5469,135,4820
13109018004,品川区,東品川４丁目,3824,136,1894,68,1930,68,1860
13109018005,品川区,東品川５丁目,0,0,0,0,0,0,0
131090190,品川区,東中延,3745,57,1788,30,1957,27,2095
13109019001,品川区,東中延１丁目,2015,20,942,10,1073,10,1100
13109019002,品川区,東中延２丁目,1730,37,846,20,884,17,995
131090200,品川区,平塚,9651,236,4689,116,4962,120,5594
13109020001,品川区,平塚１丁目,3457,102,1704,45,1753,57,2140
13109020002,品川区,平塚２丁目,3454,72,1658,39,1796,33,1919
13109020003,品川区,平塚３丁目,2740,62,1327,32,1413,30,1535
131090210,品川区,広町,61,0,38,0,23,0,42
13109021001,品川区,広町１丁目,61,0,38,0,23,0,42
13109021002,品川区,広町２丁目,0,0,0,0,0,0,0
131090220,品川区,二葉,11469,223,5825,103,5644,120,6259
13109022001,品川区,二葉１丁目,3726,73,1846,39,1880,34,1972
13109022002,品川区,二葉２丁目,2135,44,1156,25,979,19,1192
13109022003,品川区,二葉３丁目,2463,22,1272,8,1191,14,1364
13109022004,品川区,二葉４丁目,3145,84,1551,31,1594,53,1731
131090230,品川区,南大井,25668,809,12994,385,12674,424,15200
13109023001,品川区,南大井１丁目,3671,89,1865,50,1806,39,1824
13109023002,品川区,南大井２丁目,2875,91,1434,42,1441,49,1512
13109023003,品川区,南大井３丁目,5993,229,3060,110,2933,119,4155
13109023004,品川区,南大井４丁目,3099,90,1586,39,1513,51,1822
13109023005,品川区,南大井５丁目,4966,120,2580,56,2386,64,2692
13109023006,品川区,南大井６丁目,5064,190,2469,88,2595,102,3195
131090240,品川区,南品川,18812,336,9699,153,9113,183,10644
13109024001,品川区,南品川１丁目,1499,24,777,9,722,15,805
13109024002,品川区,南品川２丁目,2085,29,1101,16,984,13,1251
13109024003,品川区,南品川３丁目,2119,56,1057,31,1062,25,1117
13109024004,品川区,南品川４丁目,4351,91,2253,42,2098,49,2427
13109024005,品川区,南品川５丁目,5825,75,2959,35,2866,40,3118
13109024006,品川区,南品川６丁目,2933,61,1552,20,1381,41,1926
131090250,品川区,八潮,12389,640,5987,324,6402,316,5281
13109025001,品川区,八潮１丁目,0,0,0,0,0,0,0
13109025002,品川区,八潮２丁目,0,0,0,0,0,0,0
13109025003,品川区,八潮３丁目,49,0,49,0,0,0,49
13109025004,品川区,八潮４丁目,2,X,2,X,0,X,2
13109025005,品川区,八潮５丁目,12338,640,5936,324,6402,316,5230
131090260,品川区,豊町,14177,165,7086,78,7091,87,7497
13109026001,品川区,豊町１丁目,2814,31,1398,14,1416,17,1433
13109026002,品川区,豊町２丁目,2577,30,1328,16,1249,14,1333
13109026003,品川区,豊町３丁目,1415,18,670,8,745,10,713
13109026004,品川区,豊町４丁目,2504,29,1281,14,1223,15,1339
13109026005,品川区,豊町５丁目,1643,13,802,3,841,10,852
13109026006,品川区,豊町６丁目,3224,44,1607,23,1617,21,1827
131090270,品川区,東八潮,0,0,0,0,0,0,0
131090280,品川区,,0,0,0,0,0,0,0
13110,目黒区,,277622,6919,130947,3624,146675,3295,146162
131100010,目黒区,駒場,7083,555,3565,305,3518,250,3705
13110001001,目黒区,駒場１丁目,4079,143,2078,79,2001,64,2301
13110001002,目黒区,駒場２丁目,611,35,302,22,309,13,357
13110001003,目黒区,駒場３丁目,784,17,400,12,384,5,398
13110001004,目黒区,駒場４丁目,1609,360,785,192,824,168,649
131100020,目黒区,青葉台,8334,322,3963,168,4371,154,4761
13110002001,目黒区,青葉台１丁目,2640,113,1263,57,1377,56,1502
13110002002,目黒区,青葉台２丁目,903,36,420,17,483,19,447
13110002003,目黒区,青葉台３丁目,3080,125,1477,71,1603,54,1838
13110002004,目黒区,青葉台４丁目,1711,48,803,23,908,25,974
131100030,目黒区,東山,13317,235,6577,112,6740,123,6114
13110003001,目黒区,東山１丁目,3509,127,1698,56,1811,71,1964
13110003002,目黒区,東山２丁目,6681,48,3376,27,3305,21,2491
13110003003,目黒区,東山３丁目,3127,60,1503,29,1624,31,1659
131100040,目黒区,大橋,7301,215,3553,111,3748,104,3853
13110004001,目黒区,大橋１丁目,2743,76,1313,37,1430,39,1694
13110004002,目黒区,大橋２丁目,4558,139,2240,74,2318,65,2159
131100050,目黒区,上目黒,19398,446,9218,225,10180,221,10781
13110005001,目黒区,上目黒１丁目,1854,40,852,24,1002,16,1091
13110005002,目黒区,上目黒２丁目,4458,117,2133,57,2325,60,2610
13110005003,目黒区,上目黒３丁目,5345,123,2498,68,2847,55,2864
13110005004,目黒区,上目黒４丁目,3878,93,1864,34,2014,59,2244
13110005005,目黒区,上目黒５丁目,3863,73,1871,42,1992,31,1972
131100060,目黒区,中目黒,14897,431,7216,211,7681,220,8093
13110006001,目黒区,中目黒１丁目,3144,76,1458,41,1686,35,1907
13110006002,目黒区,中目黒２丁目,2511,110,1276,63,1235,47,1333
13110006003,目黒区,中目黒３丁目,2737,95,1267,37,1470,58,1533
13110006004,目黒区,中目黒４丁目,3085,48,1538,22,1547,26,1580
13110006005,目黒区,中目黒５丁目,3420,102,1677,48,1743,54,1740
131100070,目黒区,三田,5973,200,2720,107,3253,93,3258
13110007001,目黒区,三田１丁目,2334,89,1038,44,1296,45,1271
13110007002,目黒区,三田２丁目,3639,111,1682,63,1957,48,1987
131100080,目黒区,目黒,13322,683,6294,356,7028,327,6978
13110008001,目黒区,目黒１丁目,3938,264,1862,145,2076,119,2203
13110008002,目黒区,目黒２丁目,2628,78,1217,38,1411,40,1486
13110008003,目黒区,目黒３丁目,3140,159,1486,81,1654,78,1574
13110008004,目黒区,目黒４丁目,3616,182,1729,92,1887,90,1715
131100090,目黒区,下目黒,20459,707,9864,362,10595,345,10973
13110009001,目黒区,下目黒１丁目,1492,60,685,25,807,35,900
13110009002,目黒区,下目黒２丁目,5387,266,2654,142,2733,124,3230
13110009003,目黒区,下目黒３丁目,3894,109,1889,56,2005,53,2273
13110009004,目黒区,下目黒４丁目,2852,82,1377,48,1475,34,1453
13110009005,目黒区,下目黒５丁目,3876,121,1871,61,2005,60,1758
13110009006,目黒区,下目黒６丁目,2958,69,1388,30,1570,39,1359
131100100,目黒区,中町,9928,171,4689,88,5239,83,5228
13110010001,目黒区,中町１丁目,5096,69,2469,39,2627,30,2588
13110010002,目黒区,中町２丁目,4832,102,2220,49,2612,53,2640
131100110,目黒区,五本木,9561,160,4423,90,5138,70,5407
13110011001,目黒区,五本木１丁目,3665,60,1724,37,1941,23,2041
13110011002,目黒区,五本木２丁目,3928,70,1808,36,2120,34,2234
13110011003,目黒区,五本木３丁目,1968,30,891,17,1077,13,1132
131100120,目黒区,祐天寺,4440,111,2068,65,2372,46,2697
13110012001,目黒区,祐天寺１丁目,2403,54,1165,33,1238,21,1384
13110012002,目黒区,祐天寺２丁目,2037,57,903,32,1134,25,1313
131100130,目黒区,中央町,8109,99,3780,49,4329,50,4604
13110013001,目黒区,中央町１丁目,3330,43,1572,24,1758,19,1996
13110013002,目黒区,中央町２丁目,4779,56,2208,25,2571,31,2608
131100140,目黒区,目黒本町,23929,292,11619,150,12310,142,12470
13110014001,目黒区,目黒本町１丁目,2653,33,1303,14,1350,19,1303
13110014002,目黒区,目黒本町２丁目,4483,67,2105,33,2378,34,2396
13110014003,目黒区,目黒本町３丁目,3079,39,1514,21,1565,18,1766
13110014004,目黒区,目黒本町４丁目,4273,50,2085,26,2188,24,2019
13110014005,目黒区,目黒本町５丁目,5254,68,2550,35,2704,33,2845
13110014006,目黒区,目黒本町６丁目,4187,35,2062,21,2125,14,2141
131100150,目黒区,原町,5537,74,2675,33,2862,41,3015
13110015001,目黒区,原町１丁目,3071,55,1474,24,1597,31,1821
13110015002,目黒区,原町２丁目,2466,19,1201,9,1265,10,1194
131100160,目黒区,洗足,5742,115,2687,59,3055,56,2992
13110016001,目黒区,洗足１丁目,2911,45,1409,24,1502,21,1491
13110016002,目黒区,洗足２丁目,2831,70,1278,35,1553,35,1501
131100170,目黒区,南,7264,136,3548,78,3716,58,3686
13110017001,目黒区,南１丁目,2877,47,1453,27,1424,20,1457
13110017002,目黒区,南２丁目,2406,32,1153,18,1253,14,1149
13110017003,目黒区,南３丁目,1981,57,942,33,1039,24,1080
131100180,目黒区,碑文谷,17037,292,7873,148,9164,144,8449
13110018001,目黒区,碑文谷１丁目,3816,63,1824,31,1992,32,1708
13110018002,目黒区,碑文谷２丁目,3119,56,1388,30,1731,26,1500
13110018003,目黒区,碑文谷３丁目,2272,34,1075,18,1197,16,1054
13110018004,目黒区,碑文谷４丁目,2565,45,1184,26,1381,19,1295
13110018005,目黒区,碑文谷５丁目,3476,57,1583,27,1893,30,1952
13110018006,目黒区,碑文谷６丁目,1789,37,819,16,970,21,940
131100190,目黒区,鷹番,8898,164,4010,81,4888,83,5256
13110019001,目黒区,鷹番１丁目,2538,41,1105,21,1433,20,1395
13110019002,目黒区,鷹番２丁目,3175,65,1451,31,1724,34,1903
13110019003,目黒区,鷹番３丁目,3185,58,1454,29,1731,29,1958
131100200,目黒区,平町,6735,154,3045,92,3690,62,3506
13110020001,目黒区,平町１丁目,3584,82,1597,47,1987,35,1957
13110020002,目黒区,平町２丁目,3151,72,1448,45,1703,27,1549
131100210,目黒区,大岡山,6930,160,3307,89,3623,71,3398
13110021001,目黒区,大岡山１丁目,5596,138,2680,77,2916,61,2676
13110021002,目黒区,大岡山２丁目,1334,22,627,12,707,10,722
131100220,目黒区,緑が丘,7543,151,3580,92,3963,59,3882
13110022001,目黒区,緑が丘１丁目,3234,75,1521,42,1713,33,1616
13110022002,目黒区,緑が丘２丁目,3411,63,1619,40,1792,23,1749
13110022003,目黒区,緑が丘３丁目,898,13,440,10,458,3,517
131100230,目黒区,自由が丘,7599,201,3378,101,4221,100,4084
13110023001,目黒区,自由が丘１丁目,2647,58,1177,27,1470,31,1497
13110023002,目黒区,自由が丘２丁目,2732,76,1209,35,1523,41,1423
13110023003,目黒区,自由が丘３丁目,2220,67,992,39,1228,28,1164
131100240,目黒区,中根,6667,180,2943,96,3724,84,3716
13110024001,目黒区,中根１丁目,2967,94,1339,51,1628,43,1612
13110024002,目黒区,中根２丁目,3700,86,1604,45,2096,41,2104
131100250,目黒区,柿の木坂,9306,238,4280,133,5026,105,4518
13110025001,目黒区,柿の木坂１丁目,4060,105,1773,55,2287,50,2045
13110025002,目黒区,柿の木坂２丁目,3698,103,1748,59,1950,44,1715
13110025003,目黒区,柿の木坂３丁目,1548,30,759,19,789,11,758
131100260,目黒区,八雲,14934,302,6821,160,8113,142,7058
13110026001,目黒区,八雲１丁目,2798,62,1174,21,1624,41,1505
13110026002,目黒区,八雲２丁目,3422,62,1587,36,1835,26,1619
13110026003,目黒区,八雲３丁目,3861,97,1787,54,2074,43,1800
13110026004,目黒区,八雲４丁目,2076,41,952,22,1124,19,910
13110026005,目黒区,八雲５丁目,2777,40,1321,27,1456,13,1224
131100270,目黒区,東が丘,7379,125,3251,63,4128,62,3680
13110027001,目黒区,東が丘１丁目,4263,76,1943,39,2320,37,1954
13110027002,目黒区,東が丘２丁目,3116,49,1308,24,1808,25,1726
13111,大田区,,717082,15271,359753,7074,357329,8197,371149
131110010,大田区,大森中,10766,198,5575,84,5191,114,6182
13111001001,大田区,大森中１丁目,3571,78,1862,34,1709,44,2045
13111001002,大田区,大森中２丁目,3734,77,1896,32,1838,45,2089
13111001003,大田区,大森中３丁目,3461,43,1817,18,1644,25,2048
131110020,大田区,大森東,18393,397,9805,184,8588,213,9841
13111002001,大田区,大森東１丁目,5476,213,2726,104,2750,109,2742
13111002002,大田区,大森東２丁目,3716,68,2096,33,1620,35,2237
13111002003,大田区,大森東３丁目,2104,36,1148,17,956,19,1149
13111002004,大田区,大森東４丁目,3900,51,2073,19,1827,32,2002
13111002005,大田区,大森東５丁目,3197,29,1762,11,1435,18,1711
131110030,大田区,大森南,13199,294,6810,132,6389,162,6098
13111003001,大田区,大森南１丁目,3001,57,1528,24,1473,33,1294
13111003002,大田区,大森南２丁目,4240,114,2206,55,2034,59,1960
13111003003,大田区,大森南３丁目,3503,72,1853,30,1650,42,1675
13111003004,大田区,大森南４丁目,849,11,454,3,395,8,404
13111003005,大田区,大森南５丁目,1606,40,769,20,837,20,765
131110040,大田区,大森本町,8530,203,4421,103,4109,100,4450
13111004001,大田区,大森本町１丁目,4833,117,2475,58,2358,59,2386
13111004002,大田区,大森本町２丁目,3697,86,1946,45,1751,41,2064
131110050,大田区,大森西,33533,744,17037,331,16496,413,18160
13111005001,大田区,大森西１丁目,5973,111,2953,42,3020,69,2782
13111005002,大田区,大森西２丁目,6946,189,3637,99,3309,90,3832
13111005003,大田区,大森西３丁目,6901,147,3444,62,3457,85,4037
13111005004,大田区,大森西４丁目,4535,77,2214,28,2321,49,2091
13111005005,大田区,大森西５丁目,4886,77,2535,33,2351,44,3000
13111005006,大田区,大森西６丁目,2393,33,1227,14,1166,19,1405
13111005007,大田区,大森西７丁目,1899,110,1027,53,872,57,1013
131110060,大田区,山王,18989,443,9325,225,9664,218,9738
13111006001,大田区,山王１丁目,5152,137,2531,72,2621,65,2619
13111006002,大田区,山王２丁目,5307,120,2565,66,2742,54,2649
13111006003,大田区,山王３丁目,5128,123,2509,54,2619,69,2785
13111006004,大田区,山王４丁目,3402,63,1720,33,1682,30,1685
131110070,大田区,大森北,26917,686,13941,335,12976,351,15928
13111007001,大田区,大森北１丁目,4718,138,2310,60,2408,78,3085
13111007002,大田区,大森北２丁目,3847,91,1924,42,1923,49,2056
13111007003,大田区,大森北３丁目,6588,117,3472,55,3116,62,3864
13111007004,大田区,大森北４丁目,3425,59,1760,27,1665,32,1988
13111007005,大田区,大森北５丁目,3401,162,1836,96,1565,66,1978
13111007006,大田区,大森北６丁目,4938,119,2639,55,2299,64,2957
131110080,大田区,平和の森公園,2,X,2,X,0,X,2
131110090,大田区,平和島,339,0,292,0,47,0,294
13111009001,大田区,平和島１丁目,0,0,0,0,0,0,0
13111009002,大田区,平和島２丁目,207,0,197,0,10,0,207
13111009003,大田区,平和島３丁目,0,0,0,0,0,0,0
13111009004,大田区,平和島４丁目,0,0,0,0,0,0,0
13111009005,大田区,平和島５丁目,132,0,95,0,37,0,87
13111009006,大田区,平和島６丁目,0,0,0,0,0,0,0
131110100,大田区,昭和島,0,0,0,0,0,0,0
13111010001,大田区,昭和島１丁目,0,0,0,0,0,0,0
13111010002,大田区,昭和島２丁目,0,0,0,0,0,0,0
131110110,大田区,北馬込,7648,103,3735,50,3913,53,4210
13111011001,大田区,北馬込１丁目,3311,52,1647,22,1664,30,1822
13111011002,大田区,北馬込２丁目,4337,51,2088,28,2249,23,2388
131110120,大田区,東馬込,6242,110,3079,45,3163,65,3263
13111012001,大田区,東馬込１丁目,4613,88,2273,36,2340,52,2495
13111012002,大田区,東馬込２丁目,1629,22,806,9,823,13,768
131110130,大田区,中馬込,11087,177,5621,76,5466,101,5954
13111013001,大田区,中馬込１丁目,4134,62,2052,28,2082,34,2115
13111013002,大田区,中馬込２丁目,3134,60,1589,24,1545,36,1890
13111013003,大田区,中馬込３丁目,3819,55,1980,24,1839,31,1949
131110140,大田区,西馬込,6035,73,2984,35,3051,38,3367
13111014001,大田区,西馬込１丁目,3017,32,1494,14,1523,18,1709
13111014002,大田区,西馬込２丁目,3018,41,1490,21,1528,20,1658
131110150,大田区,南馬込,24748,391,12448,184,12300,207,12360
13111015001,大田区,南馬込１丁目,4750,85,2312,45,2438,40,2467
13111015002,大田区,南馬込２丁目,3273,64,1676,32,1597,32,1582
13111015003,大田区,南馬込３丁目,3844,64,1934,28,1910,36,1854
13111015004,大田区,南馬込４丁目,4416,68,2185,30,2231,38,1977
13111015005,大田区,南馬込５丁目,3966,36,1986,14,1980,22,2207
13111015006,大田区,南馬込６丁目,4499,74,2355,35,2144,39,2273
131110160,大田区,中央,26196,470,13093,209,13103,261,12435
13111016001,大田区,中央１丁目,2299,21,1100,11,1199,10,1180
13111016002,大田区,中央２丁目,2491,36,1273,17,1218,19,1180
13111016003,大田区,中央３丁目,4347,83,2203,39,2144,44,2058
13111016004,大田区,中央４丁目,2986,43,1462,17,1524,26,1436
13111016005,大田区,中央５丁目,3318,18,1655,9,1663,9,1357
13111016006,大田区,中央６丁目,2599,30,1280,13,1319,17,1204
13111016007,大田区,中央７丁目,2562,49,1290,21,1272,28,1252
13111016008,大田区,中央８丁目,5594,190,2830,82,2764,108,2768
131110170,大田区,池上,29866,594,14581,263,15285,331,15666
13111017001,大田区,池上１丁目,2537,21,1288,10,1249,11,1173
13111017002,大田区,池上２丁目,2114,38,1011,13,1103,25,947
13111017003,大田区,池上３丁目,4885,107,2382,46,2503,61,2720
13111017004,大田区,池上４丁目,3149,77,1553,36,1596,41,1747
13111017005,大田区,池上５丁目,3637,76,1775,27,1862,49,1765
13111017006,大田区,池上６丁目,6012,163,2880,85,3132,78,3350
13111017007,大田区,池上７丁目,4176,63,2037,27,2139,36,2350
13111017008,大田区,池上８丁目,3356,49,1655,19,1701,30,1614
131110180,大田区,田園調布本町,8166,119,4020,65,4146,54,4205
131110190,大田区,田園調布南,3749,58,1760,22,1989,36,1843
131110200,大田区,東嶺町,4932,63,2346,31,2586,32,2404
131110210,大田区,西嶺町,3194,25,1548,11,1646,14,1556
131110220,大田区,北嶺町,5493,67,2606,38,2887,29,2899
131110230,大田区,南雪谷,12463,206,5929,97,6534,109,6274
13111023001,大田区,南雪谷１丁目,3312,67,1596,44,1716,23,1951
13111023002,大田区,南雪谷２丁目,2552,51,1172,13,1380,38,1391
13111023003,大田区,南雪谷３丁目,2355,38,1142,20,1213,18,1087
13111023004,大田区,南雪谷４丁目,1911,17,893,7,1018,10,898
13111023005,大田区,南雪谷５丁目,2333,33,1126,13,1207,20,947
131110240,大田区,田園調布,18056,458,8464,250,9592,208,8453
13111024001,大田区,田園調布１丁目,6939,110,3202,57,3737,53,3512
13111024002,大田区,田園調布２丁目,4211,84,1930,47,2281,37,2036
13111024003,大田区,田園調布３丁目,1690,114,794,61,896,53,700
13111024004,大田区,田園調布４丁目,1919,56,899,30,1020,26,832
13111024005,大田区,田園調布５丁目,3297,94,1639,55,1658,39,1373
131110250,大田区,雪谷大塚町,2399,30,1165,18,1234,12,1180
131110260,大田区,鵜の木,12277,195,5861,86,6416,109,6453
13111026001,大田区,鵜の木１丁目,2905,43,1386,20,1519,23,1506
13111026002,大田区,鵜の木２丁目,5082,77,2418,28,2664,49,2713
13111026003,大田区,鵜の木３丁目,4290,75,2057,38,2233,37,2234
131110270,大田区,南久が原,5964,54,2838,27,3126,27,2902
13111027001,大田区,南久が原１丁目,1922,21,918,11,1004,10,859
13111027002,大田区,南久が原２丁目,4042,33,1920,16,2122,17,2043
131110280,大田区,千鳥,9559,147,4639,69,4920,78,4974
13111028001,大田区,千鳥１丁目,2909,38,1387,15,1522,23,1522
13111028002,大田区,千鳥２丁目,3385,64,1657,34,1728,30,1846
13111028003,大田区,千鳥３丁目,3265,45,1595,20,1670,25,1606
131110290,大田区,仲池上,9488,131,4757,57,4731,74,4390
13111029001,大田区,仲池上１丁目,4319,62,2215,23,2104,39,1901
13111029002,大田区,仲池上２丁目,5169,69,2542,34,2627,35,2489
131110300,大田区,久が原,23398,318,11389,146,12009,172,10199
13111030001,大田区,久が原１丁目,3571,52,1725,30,1846,22,1486
13111030002,大田区,久が原２丁目,4741,60,2418,24,2323,36,2138
13111030003,大田区,久が原３丁目,3538,54,1744,27,1794,27,1733
13111030004,大田区,久が原４丁目,4017,55,1877,25,2140,30,1644
13111030005,大田区,久が原５丁目,5446,74,2625,29,2821,45,2330
13111030006,大田区,久が原６丁目,2085,23,1000,11,1085,12,868
131110310,大田区,南千束,7616,155,3731,91,3885,64,3791
13111031001,大田区,南千束１丁目,2818,52,1357,25,1461,27,1343
13111031002,大田区,南千束２丁目,1749,45,841,24,908,21,784
13111031003,大田区,南千束３丁目,3049,58,1533,42,1516,16,1664
131110320,大田区,石川町,5756,158,2775,103,2981,55,2749
13111032001,大田区,石川町１丁目,1695,79,826,51,869,28,861
13111032002,大田区,石川町２丁目,4061,79,1949,52,2112,27,1888
131110330,大田区,東雪谷,17899,334,8724,170,9175,164,8618
13111033001,大田区,東雪谷１丁目,2735,64,1320,29,1415,35,1330
13111033002,大田区,東雪谷２丁目,4505,116,2101,60,2404,56,2433
13111033003,大田区,東雪谷３丁目,3626,77,1816,46,1810,31,1744
13111033004,大田区,東雪谷４丁目,3259,37,1577,15,1682,22,1419
13111033005,大田区,東雪谷５丁目,3774,40,1910,20,1864,20,1692
131110340,大田区,上池台,23022,384,11220,185,11802,199,11312
13111034001,大田区,上池台１丁目,4295,100,2011,46,2284,54,2458
13111034002,大田区,上池台２丁目,3609,78,1764,30,1845,48,1848
13111034003,大田区,上池台３丁目,4741,66,2354,39,2387,27,2155
13111034004,大田区,上池台４丁目,4473,63,2145,35,2328,28,2131
13111034005,大田区,上池台５丁目,5904,77,2946,35,2958,42,2720
131110350,大田区,北千束,12967,333,6109,182,6858,151,7357
13111035001,大田区,北千束１丁目,4978,152,2334,88,2644,64,2865
13111035002,大田区,北千束２丁目,4560,92,2120,52,2440,40,2495
13111035003,大田区,北千束３丁目,3429,89,1655,42,1774,47,1997
131110360,大田区,北糀谷,4596,92,2413,29,2183,63,2224
13111036001,大田区,北糀谷１丁目,2890,68,1506,19,1384,49,1368
13111036002,大田区,北糀谷２丁目,1706,24,907,10,799,14,856
131110370,大田区,西糀谷,20146,267,10011,103,10135,164,10485
13111037001,大田区,西糀谷１丁目,4908,69,2509,25,2399,44,2561
13111037002,大田区,西糀谷２丁目,4809,65,2344,23,2465,42,2282
13111037003,大田区,西糀谷３丁目,5989,73,2951,31,3038,42,3080
13111037004,大田区,西糀谷４丁目,4440,60,2207,24,2233,36,2562
131110380,大田区,東糀谷,12307,225,5853,100,6454,125,6367
13111038001,大田区,東糀谷１丁目,3524,51,1656,18,1868,33,1832
13111038002,大田区,東糀谷２丁目,1582,14,807,4,775,10,979
13111038003,大田区,東糀谷３丁目,2088,41,954,18,1134,23,1298
13111038004,大田区,東糀谷４丁目,2338,57,1195,33,1143,24,1015
13111038005,大田区,東糀谷５丁目,1030,9,509,5,521,4,433
13111038006,大田区,東糀谷６丁目,1745,53,732,22,1013,31,810
131110390,大田区,萩中,11618,223,5665,102,5953,121,5989
13111039001,大田区,萩中１丁目,4333,69,2067,25,2266,44,2177
13111039002,大田区,萩中２丁目,3391,52,1719,20,1672,32,1694
13111039003,大田区,萩中３丁目,3894,102,1879,57,2015,45,2118
131110400,大田区,本羽田,11985,163,6164,81,5821,82,5223
13111040001,大田区,本羽田１丁目,4228,57,2210,31,2018,26,1969
13111040002,大田区,本羽田２丁目,4354,58,2223,28,2131,30,1825
13111040003,大田区,本羽田３丁目,3403,48,1731,22,1672,26,1429
131110410,大田区,羽田旭町,527,8,290,3,237,5,348
131110420,大田区,羽田,15017,221,7648,99,7369,122,8208
13111042001,大田区,羽田１丁目,2467,44,1223,22,1244,22,1130
13111042002,大田区,羽田２丁目,1981,26,964,12,1017,14,1031
13111042003,大田区,羽田３丁目,2441,38,1282,18,1159,20,1240
13111042004,大田区,羽田４丁目,2729,51,1384,25,1345,26,1670
13111042005,大田区,羽田５丁目,3066,35,1594,10,1472,25,1950
13111042006,大田区,羽田６丁目,2333,27,1201,12,1132,15,1187
131110430,大田区,羽田空港,1,X,1,X,0,X,1
13111043001,大田区,羽田空港１丁目,0,0,0,0,0,0,0
13111043002,大田区,羽田空港２丁目,0,0,0,0,0,0,0
13111043003,大田区,羽田空港３丁目,1,X,1,X,0,X,1
131110440,大田区,西六郷,19561,356,10061,146,9500,210,8912
13111044001,大田区,西六郷１丁目,6553,113,3263,41,3290,72,2953
13111044002,大田区,西六郷２丁目,4619,74,2510,34,2109,40,2245
13111044003,大田区,西六郷３丁目,2893,73,1497,31,1396,42,1357
13111044004,大田区,西六郷４丁目,5496,96,2791,40,2705,56,2357
131110450,大田区,仲六郷,17567,359,9112,171,8455,188,9030
13111045001,大田区,仲六郷１丁目,6489,93,3281,41,3208,52,3106
13111045002,大田区,仲六郷２丁目,3984,145,2054,73,1930,72,2299
13111045003,大田区,仲六郷３丁目,3165,69,1597,31,1568,38,1562
13111045004,大田区,仲六郷４丁目,3929,52,2180,26,1749,26,2063
131110460,大田区,南蒲田,11782,360,6062,173,5720,187,7002
13111046001,大田区,南蒲田１丁目,3717,105,1951,51,1766,54,2360
13111046002,大田区,南蒲田２丁目,4403,170,2292,83,2111,87,2571
13111046003,大田区,南蒲田３丁目,3662,85,1819,39,1843,46,2071
131110470,大田区,東六郷,10854,208,5439,83,5415,125,5254
13111047001,大田区,東六郷１丁目,4005,65,1948,24,2057,41,1800
13111047002,大田区,東六郷２丁目,3182,49,1621,13,1561,36,1602
13111047003,大田区,東六郷３丁目,3667,94,1870,46,1797,48,1852
131110480,大田区,南六郷,17143,422,8803,188,8340,234,8112
13111048001,大田区,南六郷１丁目,5272,138,2707,69,2565,69,2374
13111048002,大田区,南六郷２丁目,7429,212,3836,91,3593,121,3725
13111048003,大田区,南六郷３丁目,4442,72,2260,28,2182,44,2013
131110490,大田区,下丸子,23296,264,11322,121,11974,143,11110
13111049001,大田区,下丸子１丁目,3634,35,1780,10,1854,25,2014
13111049002,大田区,下丸子２丁目,10309,105,5086,48,5223,57,4516
13111049003,大田区,下丸子３丁目,2840,43,1402,20,1438,23,1676
13111049004,大田区,下丸子４丁目,6513,81,3054,43,3459,38,2904
131110500,大田区,矢口,14807,264,7246,109,7561,155,7604
13111050001,大田区,矢口１丁目,3996,88,1934,35,2062,53,2321
13111050002,大田区,矢口２丁目,5627,108,2774,46,2853,62,2992
13111050003,大田区,矢口３丁目,5184,68,2538,28,2646,40,2291
131110510,大田区,東矢口,11925,351,6069,172,5856,179,6676
13111051001,大田区,東矢口１丁目,3432,82,1724,43,1708,39,1877
13111051002,大田区,東矢口２丁目,3503,57,1788,25,1715,32,1939
13111051003,大田区,東矢口３丁目,4990,212,2557,104,2433,108,2860
131110520,大田区,多摩川,13103,246,6573,99,6530,147,6505
13111052001,大田区,多摩川１丁目,4773,105,2400,40,2373,65,2678
13111052002,大田区,多摩川２丁目,8330,141,4173,59,4157,82,3827
131110530,大田区,新蒲田,9716,233,5086,96,4630,137,5051
13111053001,大田区,新蒲田１丁目,3109,83,1659,27,1450,56,1691
13111053002,大田区,新蒲田２丁目,2691,86,1418,41,1273,45,1479
13111053003,大田区,新蒲田３丁目,3916,64,2009,28,1907,36,1881
131110540,大田区,西蒲田,27792,1479,15012,682,12780,797,16561
13111054001,大田区,西蒲田１丁目,3926,131,2107,75,1819,56,2054
13111054002,大田区,西蒲田２丁目,1703,61,886,33,817,28,844
13111054003,大田区,西蒲田３丁目,2815,53,1541,27,1274,26,1583
13111054004,大田区,西蒲田４丁目,4392,178,2406,89,1986,89,2401
13111054005,大田区,西蒲田５丁目,2985,194,1626,83,1359,111,1849
13111054006,大田区,西蒲田６丁目,4283,295,2256,138,2027,157,2602
13111054007,大田区,西蒲田７丁目,5475,382,2969,159,2506,223,3691
13111054008,大田区,西蒲田８丁目,2213,185,1221,78,992,107,1537
131110550,大田区,蒲田,22941,1108,12145,482,10796,626,14352
13111055001,大田区,蒲田１丁目,6928,394,3742,178,3186,216,4182
13111055002,大田区,蒲田２丁目,3762,89,1918,33,1844,56,2100
13111055003,大田区,蒲田３丁目,3605,105,1846,51,1759,54,2023
13111055004,大田区,蒲田４丁目,4496,202,2363,81,2133,121,3043
13111055005,大田区,蒲田５丁目,4150,318,2276,139,1874,179,3004
131110560,大田区,蒲田本町,6010,214,3263,89,2747,125,3294
13111056001,大田区,蒲田本町１丁目,3409,128,1753,51,1656,77,1666
13111056002,大田区,蒲田本町２丁目,2601,86,1510,38,1091,48,1628
131110570,大田区,東蒲田,5464,90,2855,42,2609,48,3300
13111057001,大田区,東蒲田１丁目,2539,29,1309,11,1230,18,1650
13111057002,大田区,東蒲田２丁目,2925,61,1546,31,1379,30,1650
131110580,大田区,東海,4,X,3,X,1,X,2
13111058001,大田区,東海１丁目,0,0,0,0,0,0,0
13111058002,大田区,東海２丁目,0,0,0,0,0,0,0
13111058003,大田区,東海３丁目,4,X,3,X,1,X,2
13111058004,大田区,東海４丁目,0,0,0,0,0,0,0
13111058005,大田区,東海５丁目,0,0,0,0,0,0,0
13111058006,大田区,東海６丁目,0,0,0,0,0,0,0
131110590,大田区,城南島,5,X,5,X,0,X,5
13111059001,大田区,城南島１丁目,0,0,0,0,0,0,0
13111059002,大田区,城南島２丁目,3,X,3,X,0,X,3
13111059003,大田区,城南島３丁目,0,0,0,0,0,0,0
13111059004,大田区,城南島４丁目,2,X,2,X,0,X,2
13111059005,大田区,城南島５丁目,0,0,0,0,0,0,0
13111059006,大田区,城南島６丁目,0,0,0,0,0,0,0
13111059007,大田区,城南島７丁目,0,0,0,0,0,0,0
131110600,大田区,京浜島,1,X,1,X,0,X,1
13111060001,大田区,京浜島１丁目,0,0,0,0,0,0,0
13111060002,大田区,京浜島２丁目,0,0,0,0,0,0,0
13111060003,大田区,京浜島３丁目,1,X,1,X,0,X,1
131110610,大田区,羽田沖水面,0,0,0,0,0,0,0
131110620,大田区,多摩川河川敷,26,X,21,X,5,X,26
13111062001,大田区,多摩川河川敷（上流）,6,X,5,X,1,X,6
13111062002,大田区,多摩川河川敷（下流）,20,X,16,X,4,X,20
131110630,大田区,ふるさとの浜辺公園,0,0,0,0,0,0,0
13112,世田谷区,,903346,16217,428874,8330,474472,7887,463632
131120010,世田谷区,池尻,16629,329,7946,170,8683,159,9489
13112001001,世田谷区,池尻１丁目,1635,10,842,7,793,3,685
13112001002,世田谷区,池尻２丁目,4766,105,2226,51,2540,54,2888
13112001003,世田谷区,池尻３丁目,4958,97,2341,49,2617,48,3219
13112001004,世田谷区,池尻４丁目,5270,117,2537,63,2733,54,2697
131120020,世田谷区,三宿,8293,145,3990,80,4303,65,4872
13112002001,世田谷区,三宿１丁目,4078,74,1930,39,2148,35,2533
13112002002,世田谷区,三宿２丁目,4215,71,2060,41,2155,30,2339
131120030,世田谷区,太子堂,18852,369,8815,180,10037,189,11457
13112003001,世田谷区,太子堂１丁目,3106,68,1433,27,1673,41,1765
13112003002,世田谷区,太子堂２丁目,4274,89,1969,47,2305,42,2836
13112003003,世田谷区,太子堂３丁目,4543,71,2158,38,2385,33,2549
13112003004,世田谷区,太子堂４丁目,2915,58,1370,26,1545,32,1956
13112003005,世田谷区,太子堂５丁目,4014,83,1885,42,2129,41,2351
131120040,世田谷区,三軒茶屋,13513,273,6233,141,7280,132,8076
13112004001,世田谷区,三軒茶屋１丁目,5642,104,2560,47,3082,57,3352
13112004002,世田谷区,三軒茶屋２丁目,7871,169,3673,94,4198,75,4724
131120050,世田谷区,若林,19161,331,9342,183,9819,148,10892
13112005001,世田谷区,若林１丁目,4397,99,2147,58,2250,41,2666
13112005002,世田谷区,若林２丁目,3620,51,1747,25,1873,26,1961
13112005003,世田谷区,若林３丁目,3375,69,1602,36,1773,33,2038
13112005004,世田谷区,若林４丁目,4299,72,2134,42,2165,30,2310
13112005005,世田谷区,若林５丁目,3470,40,1712,22,1758,18,1917
131120060,世田谷区,世田谷,16076,241,7420,105,8656,136,8952
13112006001,世田谷区,世田谷１丁目,6220,116,2911,49,3309,67,3434
13112006002,世田谷区,世田谷２丁目,3366,54,1557,25,1809,29,1811
13112006003,世田谷区,世田谷３丁目,3305,35,1482,16,1823,19,1880
13112006004,世田谷区,世田谷４丁目,3185,36,1470,15,1715,21,1827
131120070,世田谷区,桜,12096,133,5815,73,6281,60,5656
13112007001,世田谷区,桜１丁目,4653,47,2180,26,2473,21,2251
13112007002,世田谷区,桜２丁目,3266,38,1639,20,1627,18,1570
13112007003,世田谷区,桜３丁目,4177,48,1996,27,2181,21,1835
131120080,世田谷区,弦巻,24017,339,11271,157,12746,182,11449
13112008001,世田谷区,弦巻１丁目,5132,51,2474,20,2658,31,2196
13112008002,世田谷区,弦巻２丁目,4609,79,2126,38,2483,41,2180
13112008003,世田谷区,弦巻３丁目,4064,80,1899,41,2165,39,2032
13112008004,世田谷区,弦巻４丁目,4877,67,2222,29,2655,38,2563
13112008005,世田谷区,弦巻５丁目,5335,62,2550,29,2785,33,2478
131120090,世田谷区,経堂,18914,306,8944,150,9970,156,10572
13112009001,世田谷区,経堂１丁目,4236,64,1940,28,2296,36,2601
13112009002,世田谷区,経堂２丁目,3086,57,1447,25,1639,32,1763
13112009003,世田谷区,経堂３丁目,3110,39,1495,20,1615,19,1659
13112009004,世田谷区,経堂４丁目,4256,60,2033,32,2223,28,2275
13112009005,世田谷区,経堂５丁目,4226,86,2029,45,2197,41,2274
131120100,世田谷区,宮坂,11727,225,5459,109,6268,116,6639
13112010001,世田谷区,宮坂１丁目,3967,64,1839,28,2128,36,2147
13112010002,世田谷区,宮坂２丁目,3152,78,1475,40,1677,38,1810
13112010003,世田谷区,宮坂３丁目,4608,83,2145,41,2463,42,2682
131120110,世田谷区,桜丘,19557,294,9366,143,10191,151,9282
13112011001,世田谷区,桜丘１丁目,2446,54,1202,34,1244,20,1149
13112011002,世田谷区,桜丘２丁目,3784,48,1733,24,2051,24,1936
13112011003,世田谷区,桜丘３丁目,4419,92,2238,40,2181,52,1836
13112011004,世田谷区,桜丘４丁目,4224,48,2044,25,2180,23,1889
13112011005,世田谷区,桜丘５丁目,4684,52,2149,20,2535,32,2472
131120120,世田谷区,下馬,27449,422,13006,224,14443,198,14632
13112012001,世田谷区,下馬１丁目,5848,85,2890,49,2958,36,3117
13112012002,世田谷区,下馬２丁目,5792,72,2590,38,3202,34,3291
13112012003,世田谷区,下馬３丁目,3813,47,1902,25,1911,22,1974
13112012004,世田谷区,下馬４丁目,2149,43,1033,20,1116,23,1013
13112012005,世田谷区,下馬５丁目,3986,75,1905,36,2081,39,2079
13112012006,世田谷区,下馬６丁目,5861,100,2686,56,3175,44,3158
131120130,世田谷区,野沢,15336,289,7257,162,8079,127,7878
13112013001,世田谷区,野沢１丁目,3734,103,1774,48,1960,55,1877
13112013002,世田谷区,野沢２丁目,3151,50,1515,34,1636,16,1719
13112013003,世田谷区,野沢３丁目,5485,87,2555,52,2930,35,2616
13112013004,世田谷区,野沢４丁目,2966,49,1413,28,1553,21,1666
131120140,世田谷区,上馬,20143,414,9577,223,10566,191,11869
13112014001,世田谷区,上馬１丁目,4887,91,2369,46,2518,45,2948
13112014002,世田谷区,上馬２丁目,4629,104,2238,61,2391,43,2890
13112014003,世田谷区,上馬３丁目,1438,32,663,18,775,14,855
13112014004,世田谷区,上馬４丁目,4599,93,2097,44,2502,49,2800
13112014005,世田谷区,上馬５丁目,4590,94,2210,54,2380,40,2376
131120150,世田谷区,駒沢,16983,367,7905,186,9078,181,9035
13112015001,世田谷区,駒沢１丁目,3235,94,1525,50,1710,44,1530
13112015002,世田谷区,駒沢２丁目,5062,126,2290,55,2772,71,2848
13112015003,世田谷区,駒沢３丁目,2836,32,1341,21,1495,11,1627
13112015004,世田谷区,駒沢４丁目,3554,82,1685,40,1869,42,1893
13112015005,世田谷区,駒沢５丁目,2296,33,1064,20,1232,13,1137
131120160,世田谷区,代田,22727,600,10929,345,11798,255,13202
13112016001,世田谷区,代田１丁目,3764,82,1825,47,1939,35,2143
13112016002,世田谷区,代田２丁目,3533,103,1701,60,1832,43,1971
13112016003,世田谷区,代田３丁目,4924,83,2343,44,2581,39,2791
13112016004,世田谷区,代田４丁目,3877,115,1819,62,2058,53,2221
13112016005,世田谷区,代田５丁目,3193,92,1567,63,1626,29,1962
13112016006,世田谷区,代田６丁目,3436,125,1674,69,1762,56,2114
131120170,世田谷区,梅丘,8993,135,4179,77,4814,58,4874
13112017001,世田谷区,梅丘１丁目,3915,60,1777,29,2138,31,2334
13112017002,世田谷区,梅丘２丁目,3427,48,1626,30,1801,18,1707
13112017003,世田谷区,梅丘３丁目,1651,27,776,18,875,9,833
131120180,世田谷区,豪徳寺,6530,97,3044,51,3486,46,3695
13112018001,世田谷区,豪徳寺１丁目,4140,82,1910,43,2230,39,2432
13112018002,世田谷区,豪徳寺２丁目,2390,15,1134,8,1256,7,1263
131120190,世田谷区,代沢,16476,408,8061,208,8415,200,9111
13112019001,世田谷区,代沢１丁目,2932,50,1386,22,1546,28,1604
13112019002,世田谷区,代沢２丁目,4575,148,2252,74,2323,74,2579
13112019003,世田谷区,代沢３丁目,2103,54,990,30,1113,24,999
13112019004,世田谷区,代沢４丁目,4268,88,2129,43,2139,45,2331
13112019005,世田谷区,代沢５丁目,2598,68,1304,39,1294,29,1598
131120200,世田谷区,羽根木,6772,156,3274,83,3498,73,3903
13112020001,世田谷区,羽根木１丁目,2775,78,1365,46,1410,32,1703
13112020002,世田谷区,羽根木２丁目,3997,78,1909,37,2088,41,2200
131120210,世田谷区,大原,7854,214,3911,122,3943,92,5046
13112021001,世田谷区,大原１丁目,5119,142,2560,76,2559,66,3247
13112021002,世田谷区,大原２丁目,2735,72,1351,46,1384,26,1799
131120220,世田谷区,北沢,18483,529,9068,291,9415,238,11301
13112022001,世田谷区,北沢１丁目,5230,168,2591,91,2639,77,3040
13112022002,世田谷区,北沢２丁目,2622,65,1271,35,1351,30,1789
13112022003,世田谷区,北沢３丁目,3186,110,1603,69,1583,41,2020
13112022004,世田谷区,北沢４丁目,3269,84,1604,51,1665,33,1951
13112022005,世田谷区,北沢５丁目,4176,102,1999,45,2177,57,2501
131120230,世田谷区,松原,29382,584,13894,314,15488,270,17209
13112023001,世田谷区,松原１丁目,6248,146,2995,74,3253,72,3993
13112023002,世田谷区,松原２丁目,4754,100,2280,59,2474,41,3037
13112023003,世田谷区,松原３丁目,5136,103,2419,43,2717,60,3017
13112023004,世田谷区,松原４丁目,3461,46,1593,23,1868,23,1733
13112023005,世田谷区,松原５丁目,5640,116,2631,62,3009,54,3117
13112023006,世田谷区,松原６丁目,4143,73,1976,53,2167,20,2312
131120240,世田谷区,赤堤,19773,314,9210,167,10563,147,10571
13112024001,世田谷区,赤堤１丁目,4561,44,2083,22,2478,22,2352
13112024002,世田谷区,赤堤２丁目,3698,70,1700,41,1998,29,1973
13112024003,世田谷区,赤堤３丁目,3739,69,1779,37,1960,32,1829
13112024004,世田谷区,赤堤４丁目,3982,73,1872,35,2110,38,2314
13112024005,世田谷区,赤堤５丁目,3793,58,1776,32,2017,26,2103
131120250,世田谷区,桜上水,13047,230,6370,107,6677,123,6692
13112025001,世田谷区,桜上水１丁目,2943,43,1446,22,1497,21,1462
13112025002,世田谷区,桜上水２丁目,2007,35,975,19,1032,16,1071
13112025003,世田谷区,桜上水３丁目,1750,24,881,9,869,15,851
13112025004,世田谷区,桜上水４丁目,3449,84,1690,40,1759,44,1736
13112025005,世田谷区,桜上水５丁目,2898,44,1378,17,1520,27,1572
131120260,世田谷区,東玉川,8195,131,3818,65,4377,66,3927
13112026001,世田谷区,東玉川１丁目,4052,55,1895,28,2157,27,1833
13112026002,世田谷区,東玉川２丁目,4143,76,1923,37,2220,39,2094
131120270,世田谷区,奥沢,28579,557,12861,281,15718,276,15255
13112027001,世田谷区,奥沢１丁目,5177,83,2381,38,2796,45,2565
13112027002,世田谷区,奥沢２丁目,4406,102,1932,53,2474,49,2330
13112027003,世田谷区,奥沢３丁目,4052,62,1800,28,2252,34,2158
13112027004,世田谷区,奥沢４丁目,2179,43,996,23,1183,20,1133
13112027005,世田谷区,奥沢５丁目,3693,88,1616,42,2077,46,2221
13112027006,世田谷区,奥沢６丁目,3346,78,1494,46,1852,32,1824
13112027007,世田谷区,奥沢７丁目,3654,54,1719,31,1935,23,1961
13112027008,世田谷区,奥沢８丁目,2072,47,923,20,1149,27,1063
131120280,世田谷区,玉川田園調布,2246,100,1034,51,1212,49,1043
13112028001,世田谷区,玉川田園調布１丁目,1156,54,526,26,630,28,511
13112028002,世田谷区,玉川田園調布２丁目,1090,46,508,25,582,21,532
131120290,世田谷区,玉堤,5784,76,2868,41,2916,35,2644
13112029001,世田谷区,玉堤１丁目,4659,66,2319,36,2340,30,2131
13112029002,世田谷区,玉堤２丁目,1125,10,549,5,576,5,513
131120300,世田谷区,等々力,26499,403,12299,206,14200,197,12846
13112030001,世田谷区,等々力１丁目,2623,49,1198,23,1425,26,1133
13112030002,世田谷区,等々力２丁目,3733,56,1694,27,2039,29,1936
13112030003,世田谷区,等々力３丁目,2529,25,1115,13,1414,12,1263
13112030004,世田谷区,等々力４丁目,2276,33,1002,10,1274,23,1275
13112030005,世田谷区,等々力５丁目,3396,60,1557,33,1839,27,1704
13112030006,世田谷区,等々力６丁目,4525,71,2173,38,2352,33,2236
13112030007,世田谷区,等々力７丁目,4139,50,1966,31,2173,19,1855
13112030008,世田谷区,等々力８丁目,3278,59,1594,31,1684,28,1444
131120310,世田谷区,尾山台,6387,120,2975,61,3412,59,3145
13112031001,世田谷区,尾山台１丁目,1645,39,789,16,856,23,721
13112031002,世田谷区,尾山台２丁目,1936,36,872,20,1064,16,881
13112031003,世田谷区,尾山台３丁目,2806,45,1314,25,1492,20,1543
131120320,世田谷区,上野毛,12864,293,5966,163,6898,130,6255
13112032001,世田谷区,上野毛１丁目,4182,106,1869,54,2313,52,2243
13112032002,世田谷区,上野毛２丁目,2497,59,1189,33,1308,26,1143
13112032003,世田谷区,上野毛３丁目,2080,44,964,27,1116,17,950
13112032004,世田谷区,上野毛４丁目,4105,84,1944,49,2161,35,1919
131120330,世田谷区,野毛,6104,157,3025,99,3079,58,2755
13112033001,世田谷区,野毛１丁目,1954,50,942,38,1012,12,926
13112033002,世田谷区,野毛２丁目,2594,44,1295,24,1299,20,1108
13112033003,世田谷区,野毛３丁目,1556,63,788,37,768,26,721
131120340,世田谷区,中町,13723,326,6275,157,7448,169,6224
13112034001,世田谷区,中町１丁目,1934,29,875,13,1059,16,869
13112034002,世田谷区,中町２丁目,3221,64,1483,33,1738,31,1587
13112034003,世田谷区,中町３丁目,2919,48,1346,21,1573,27,1369
13112034004,世田谷区,中町４丁目,2835,72,1356,34,1479,38,1201
13112034005,世田谷区,中町５丁目,2814,113,1215,56,1599,57,1198
131120350,世田谷区,上用賀,15254,210,7197,108,8057,102,6931
13112035001,世田谷区,上用賀１丁目,2910,38,1360,23,1550,15,1447
13112035002,世田谷区,上用賀２丁目,1003,16,419,5,584,11,431
13112035003,世田谷区,上用賀３丁目,2382,47,1062,23,1320,24,1077
13112035004,世田谷区,上用賀４丁目,3364,55,1659,28,1705,27,1428
13112035005,世田谷区,上用賀５丁目,2849,29,1374,16,1475,13,1318
13112035006,世田谷区,上用賀６丁目,2746,25,1323,13,1423,12,1230
131120360,世田谷区,用賀,14823,321,6881,164,7942,157,7744
13112036001,世田谷区,用賀１丁目,3496,63,1658,35,1838,28,1489
13112036002,世田谷区,用賀２丁目,4258,140,1916,70,2342,70,2320
13112036003,世田谷区,用賀３丁目,4221,65,1999,34,2222,31,2209
13112036004,世田谷区,用賀４丁目,2848,53,1308,25,1540,28,1726
131120370,世田谷区,玉川,12645,308,5823,157,6822,151,6392
13112037001,世田谷区,玉川１丁目,3443,93,1613,45,1830,48,1609
13112037002,世田谷区,玉川２丁目,1975,29,897,20,1078,9,1034
13112037003,世田谷区,玉川３丁目,3577,106,1663,55,1914,51,1897
13112037004,世田谷区,玉川４丁目,3650,80,1650,37,2000,43,1852
131120380,世田谷区,瀬田,14525,439,6868,227,7657,212,6590
13112038001,世田谷区,瀬田１丁目,2780,109,1367,66,1413,43,1197
13112038002,世田谷区,瀬田２丁目,3205,120,1527,63,1678,57,1537
13112038003,世田谷区,瀬田３丁目,2220,81,1033,43,1187,38,1054
13112038004,世田谷区,瀬田４丁目,3410,62,1547,31,1863,31,1529
13112038005,世田谷区,瀬田５丁目,2910,67,1394,24,1516,43,1273
131120390,世田谷区,玉川台,6108,133,2796,69,3312,64,3269
13112039001,世田谷区,玉川台１丁目,2072,44,934,19,1138,25,1167
13112039002,世田谷区,玉川台２丁目,4036,89,1862,50,2174,39,2102
131120400,世田谷区,駒沢公園,3,0,3,0,0,0,3
131120410,世田谷区,新町,8747,165,3991,83,4756,82,4455
13112041001,世田谷区,新町１丁目,3237,64,1513,35,1724,29,1587
13112041002,世田谷区,新町２丁目,3482,71,1562,34,1920,37,1853
13112041003,世田谷区,新町３丁目,2028,30,916,14,1112,16,1015
131120420,世田谷区,桜新町,6907,120,3115,50,3792,70,3657
13112042001,世田谷区,桜新町１丁目,3595,78,1591,32,2004,46,1872
13112042002,世田谷区,桜新町２丁目,3312,42,1524,18,1788,24,1785
131120430,世田谷区,深沢,24079,516,11810,267,12269,249,10448
13112043001,世田谷区,深沢１丁目,3261,57,1599,33,1662,24,1447
13112043002,世田谷区,深沢２丁目,4122,135,1961,67,2161,68,1671
13112043003,世田谷区,深沢３丁目,2527,37,1266,16,1261,21,1189
13112043004,世田谷区,深沢４丁目,3444,47,1660,24,1784,23,1492
13112043005,世田谷区,深沢５丁目,4159,43,2117,28,2042,15,1753
13112043006,世田谷区,深沢６丁目,2530,55,1274,30,1256,25,1130
13112043007,世田谷区,深沢７丁目,2280,87,1138,37,1142,50,969
13112043008,世田谷区,深沢８丁目,1756,55,795,32,961,23,797
131120440,世田谷区,成城,22596,275,10465,136,12131,139,9736
13112044001,世田谷区,成城１丁目,1875,14,910,6,965,8,871
13112044002,世田谷区,成城２丁目,2897,27,1310,14,1587,13,1409
13112044003,世田谷区,成城３丁目,2104,29,1019,13,1085,16,874
13112044004,世田谷区,成城４丁目,3361,35,1600,19,1761,16,1376
13112044005,世田谷区,成城５丁目,2048,25,916,13,1132,12,851
13112044006,世田谷区,成城６丁目,1561,22,706,12,855,10,695
13112044007,世田谷区,成城７丁目,2466,36,1150,13,1316,23,1035
13112044008,世田谷区,成城８丁目,3801,62,1680,32,2121,30,1529
13112044009,世田谷区,成城９丁目,2483,25,1174,14,1309,11,1096
131120450,世田谷区,祖師谷,19548,270,9193,133,10355,137,9659
13112045001,世田谷区,祖師谷１丁目,3152,46,1475,24,1677,22,1762
13112045002,世田谷区,祖師谷２丁目,2268,52,1057,30,1211,22,1396
13112045003,世田谷区,祖師谷３丁目,4492,58,2029,26,2463,32,2321
13112045004,世田谷区,祖師谷４丁目,3490,36,1600,17,1890,19,1658
13112045005,世田谷区,祖師谷５丁目,2867,39,1356,20,1511,19,1243
13112045006,世田谷区,祖師谷６丁目,3279,39,1676,16,1603,23,1279
131120460,世田谷区,千歳台,18384,204,9017,98,9367,106,7880
13112046001,世田谷区,千歳台１丁目,3482,60,1634,26,1848,34,1594
13112046002,世田谷区,千歳台２丁目,3330,26,1628,16,1702,10,1622
13112046003,世田谷区,千歳台３丁目,2607,25,1326,9,1281,16,1177
13112046004,世田谷区,千歳台４丁目,2588,38,1302,18,1286,20,1000
13112046005,世田谷区,千歳台５丁目,2085,16,1062,6,1023,10,897
13112046006,世田谷区,千歳台６丁目,4292,39,2065,23,2227,16,1590
131120470,世田谷区,船橋,26606,367,12682,181,13924,186,12860
13112047001,世田谷区,船橋１丁目,5297,75,2460,44,2837,31,2898
13112047002,世田谷区,船橋２丁目,2639,35,1189,14,1450,21,1025
13112047003,世田谷区,船橋３丁目,3818,52,1816,29,2002,23,1686
13112047004,世田谷区,船橋４丁目,3271,30,1571,12,1700,18,1489
13112047005,世田谷区,船橋５丁目,4863,85,2354,37,2509,48,2253
13112047006,世田谷区,船橋６丁目,2314,30,1129,13,1185,17,1229
13112047007,世田谷区,船橋７丁目,4404,60,2163,32,2241,28,2280
131120480,世田谷区,喜多見,19559,253,9536,114,10023,139,9028
13112048001,世田谷区,喜多見１丁目,2082,21,1025,9,1057,12,748
13112048002,世田谷区,喜多見２丁目,1658,13,741,4,917,9,774
13112048003,世田谷区,喜多見３丁目,1455,31,717,19,738,12,580
13112048004,世田谷区,喜多見４丁目,2616,29,1354,13,1262,16,1216
13112048005,世田谷区,喜多見５丁目,1850,21,930,8,920,13,853
13112048006,世田谷区,喜多見６丁目,1539,21,748,8,791,13,669
13112048007,世田谷区,喜多見７丁目,3201,49,1638,27,1563,22,1536
13112048008,世田谷区,喜多見８丁目,2266,24,1067,14,1199,10,1211
13112048009,世田谷区,喜多見９丁目,2892,44,1316,12,1576,32,1441
131120490,世田谷区,宇奈根,5777,90,2978,57,2799,33,2248
13112049001,世田谷区,宇奈根１丁目,2218,30,1146,17,1072,13,937
13112049002,世田谷区,宇奈根２丁目,2396,31,1217,18,1179,13,832
13112049003,世田谷区,宇奈根３丁目,1163,29,615,22,548,7,479
131120500,世田谷区,鎌田,7930,152,3929,78,4001,74,3456
13112050001,世田谷区,鎌田１丁目,1079,34,541,18,538,16,530
13112050002,世田谷区,鎌田２丁目,2845,55,1421,22,1424,33,1243
13112050003,世田谷区,鎌田３丁目,2618,46,1256,29,1362,17,1134
13112050004,世田谷区,鎌田４丁目,1388,17,711,9,677,8,549
131120510,世田谷区,岡本,7947,125,3890,70,4057,55,3298
13112051001,世田谷区,岡本１丁目,3109,47,1533,25,1576,22,1353
13112051002,世田谷区,岡本２丁目,1995,33,966,24,1029,9,783
13112051003,世田谷区,岡本３丁目,2843,45,1391,21,1452,24,1162
131120520,世田谷区,大蔵,8348,101,3972,52,4376,49,3986
13112052001,世田谷区,大蔵１丁目,2032,20,970,13,1062,7,864
13112052002,世田谷区,大蔵２丁目,1630,9,725,4,905,5,877
13112052003,世田谷区,大蔵３丁目,1757,35,848,14,909,21,1100
13112052004,世田谷区,大蔵４丁目,194,1,81,0,113,1,57
13112052005,世田谷区,大蔵５丁目,1719,25,847,15,872,10,681
13112052006,世田谷区,大蔵６丁目,1016,11,501,6,515,5,407
131120530,世田谷区,砧,25380,315,12225,173,13155,142,12042
13112053001,世田谷区,砧１丁目,3896,35,1881,14,2015,21,1811
13112053002,世田谷区,砧２丁目,3407,67,1624,35,1783,32,1644
13112053003,世田谷区,砧３丁目,4090,57,2126,34,1964,23,1811
13112053004,世田谷区,砧４丁目,4069,40,1959,28,2110,12,1905
13112053005,世田谷区,砧５丁目,2438,27,1183,17,1255,10,1128
13112053006,世田谷区,砧６丁目,2555,33,1170,15,1385,18,1317
13112053007,世田谷区,砧７丁目,1680,31,840,18,840,13,816
13112053008,世田谷区,砧８丁目,3245,25,1442,12,1803,13,1610
131120540,世田谷区,砧公園,0,0,0,0,0,0,0
131120550,世田谷区,上北沢,16504,362,7818,188,8686,174,8867
13112055001,世田谷区,上北沢１丁目,3861,67,1820,29,2041,38,1870
13112055002,世田谷区,上北沢２丁目,515,5,267,5,248,0,164
13112055003,世田谷区,上北沢３丁目,2636,23,1221,8,1415,15,1330
13112055004,世田谷区,上北沢４丁目,4509,177,2118,105,2391,72,2815
13112055005,世田谷区,上北沢５丁目,4983,90,2392,41,2591,49,2688
131120560,世田谷区,八幡山,8871,122,4744,66,4127,56,4309
13112056001,世田谷区,八幡山１丁目,2699,34,1315,18,1384,16,1242
13112056002,世田谷区,八幡山２丁目,2031,13,1424,11,607,2,619
13112056003,世田谷区,八幡山３丁目,4141,75,2005,37,2136,38,2448
131120570,世田谷区,上祖師谷,19260,413,9334,183,9926,230,8590
13112057001,世田谷区,上祖師谷１丁目,3227,47,1480,15,1747,32,1788
13112057002,世田谷区,上祖師谷２丁目,4024,30,2062,14,1962,16,1787
13112057003,世田谷区,上祖師谷３丁目,1450,34,733,16,717,18,596
13112057004,世田谷区,上祖師谷４丁目,3210,239,1560,109,1650,130,1249
13112057005,世田谷区,上祖師谷５丁目,3413,41,1620,17,1793,24,1459
13112057006,世田谷区,上祖師谷６丁目,2167,13,1052,7,1115,6,860
13112057007,世田谷区,上祖師谷７丁目,1769,9,827,5,942,4,851
131120580,世田谷区,粕谷,11591,115,5569,47,6022,68,5287
13112058001,世田谷区,粕谷１丁目,2768,25,1391,11,1377,14,1158
13112058002,世田谷区,粕谷２丁目,3708,26,1723,8,1985,18,1471
13112058003,世田谷区,粕谷３丁目,2726,24,1342,11,1384,13,1321
13112058004,世田谷区,粕谷４丁目,2389,40,1113,17,1276,23,1337
131120590,世田谷区,給田,12687,163,6063,78,6624,85,6216
13112059001,世田谷区,給田１丁目,1199,27,583,14,616,13,650
13112059002,世田谷区,給田２丁目,1391,13,690,8,701,5,746
13112059003,世田谷区,給田３丁目,3958,43,1838,23,2120,20,2170
13112059004,世田谷区,給田４丁目,3644,50,1798,23,1846,27,1664
13112059005,世田谷区,給田５丁目,2495,30,1154,10,1341,20,986
131120600,世田谷区,南烏山,22789,442,10439,203,12350,239,13388
13112060001,世田谷区,南烏山１丁目,3404,51,1593,26,1811,25,1841
13112060002,世田谷区,南烏山２丁目,4617,81,2056,36,2561,45,2613
13112060003,世田谷区,南烏山３丁目,4188,87,1912,38,2276,49,2144
13112060004,世田谷区,南烏山４丁目,3023,70,1419,31,1604,39,2030
13112060005,世田谷区,南烏山５丁目,2153,27,936,14,1217,13,1357
13112060006,世田谷区,南烏山６丁目,5404,126,2523,58,2881,68,3403
131120610,世田谷区,北烏山,27314,329,13129,173,14185,156,12845
13112061001,世田谷区,北烏山１丁目,5092,56,2477,32,2615,24,2318
13112061002,世田谷区,北烏山２丁目,2337,28,1098,16,1239,12,1218
13112061003,世田谷区,北烏山３丁目,3558,87,1733,49,1825,38,1892
13112061004,世田谷区,北烏山４丁目,2085,13,935,5,1150,8,873
13112061005,世田谷区,北烏山５丁目,1385,13,687,8,698,5,576
13112061006,世田谷区,北烏山６丁目,3878,40,1948,20,1930,20,1853
13112061007,世田谷区,北烏山７丁目,3357,26,1614,12,1743,14,1496
13112061008,世田谷区,北烏山８丁目,3201,26,1451,15,1750,11,1387
13112061009,世田谷区,北烏山９丁目,2421,40,1186,16,1235,24,1232
13113,渋谷区,,224533,7110,107986,3853,116547,3257,135749
131130010,渋谷区,恵比寿,15411,417,7255,223,8156,194,9937
13113001001,渋谷区,恵比寿１丁目,3744,83,1733,43,2011,40,2471
13113001002,渋谷区,恵比寿２丁目,4300,120,2012,66,2288,54,2817
13113001003,渋谷区,恵比寿３丁目,4501,139,2124,75,2377,64,2770
13113001004,渋谷区,恵比寿４丁目,2866,75,1386,39,1480,36,1879
131130020,渋谷区,広尾,15942,871,7086,460,8856,411,8384
13113002001,渋谷区,広尾１丁目,3092,119,1454,69,1638,50,2026
13113002002,渋谷区,広尾２丁目,1953,183,932,93,1021,90,889
13113002003,渋谷区,広尾３丁目,2946,235,1404,145,1542,90,1412
13113002004,渋谷区,広尾４丁目,4599,231,1884,111,2715,120,1956
13113002005,渋谷区,広尾５丁目,3352,103,1412,42,1940,61,2101
131130030,渋谷区,東,8239,198,3986,117,4253,81,5282
13113003001,渋谷区,東１丁目,2097,61,1057,39,1040,22,1343
13113003002,渋谷区,東２丁目,2845,50,1346,33,1499,17,1816
13113003003,渋谷区,東３丁目,2271,57,1068,30,1203,27,1527
13113003004,渋谷区,東４丁目,1026,30,515,15,511,15,596
131130040,渋谷区,恵比寿南,4502,112,2076,75,2426,37,2823
13113004001,渋谷区,恵比寿南１丁目,750,13,359,8,391,5,535
13113004002,渋谷区,恵比寿南２丁目,1918,63,901,43,1017,20,1184
13113004003,渋谷区,恵比寿南３丁目,1834,36,816,24,1018,12,1104
131130050,渋谷区,恵比寿西,4121,120,1908,68,2213,52,2571
13113005001,渋谷区,恵比寿西１丁目,1826,58,848,36,978,22,1149
13113005002,渋谷区,恵比寿西２丁目,2295,62,1060,32,1235,30,1422
131130060,渋谷区,代官山町,2007,40,950,21,1057,19,1160
131130070,渋谷区,猿楽町,1945,68,850,37,1095,31,1019
131130080,渋谷区,鉢山町,1206,62,570,35,636,27,596
131130090,渋谷区,鴬谷町,1850,123,876,76,974,47,995
131130100,渋谷区,渋谷,4074,111,2004,65,2070,46,2565
13113010001,渋谷区,渋谷１丁目,1989,51,922,26,1067,25,1075
13113010002,渋谷区,渋谷２丁目,606,17,290,9,316,8,441
13113010003,渋谷区,渋谷３丁目,1093,25,611,15,482,10,857
13113010004,渋谷区,渋谷４丁目,386,18,181,15,205,3,192
131130110,渋谷区,桜丘町,1810,61,905,33,905,28,1194
131130120,渋谷区,南平台町,1789,75,858,33,931,42,956
131130130,渋谷区,道玄坂,598,20,360,15,238,5,513
13113013001,渋谷区,道玄坂１丁目,81,0,37,0,44,0,56
13113013002,渋谷区,道玄坂２丁目,517,20,323,15,194,5,457
131130140,渋谷区,円山町,2357,117,1290,76,1067,41,1922
131130150,渋谷区,神泉町,2257,62,1113,34,1144,28,1490
131130160,渋谷区,松涛,3084,201,1453,125,1631,76,1614
13113016001,渋谷区,松涛１丁目,1316,124,647,78,669,46,678
13113016002,渋谷区,松涛２丁目,1768,77,806,47,962,30,936
131130170,渋谷区,神山町,2642,120,1293,74,1349,46,1801
131130180,渋谷区,宇田川町,680,37,349,20,331,17,466
131130190,渋谷区,神南,520,37,266,23,254,14,360
13113019001,渋谷区,神南１丁目,505,37,252,23,253,14,345
13113019002,渋谷区,神南２丁目,15,0,14,0,1,0,15
131130200,渋谷区,代々木神園町,160,46,104,25,56,21,87
131130210,渋谷区,上原,9878,341,4663,189,5215,152,5531
13113021001,渋谷区,上原１丁目,2964,44,1412,24,1552,20,1946
13113021002,渋谷区,上原２丁目,3992,187,1880,100,2112,87,2000
13113021003,渋谷区,上原３丁目,2922,110,1371,65,1551,45,1585
131130220,渋谷区,富ケ谷,8976,268,4322,144,4654,124,5470
13113022001,渋谷区,富ケ谷１丁目,4047,134,1903,77,2144,57,2513
13113022002,渋谷区,富ケ谷２丁目,4929,134,2419,67,2510,67,2957
131130230,渋谷区,西原,10978,366,5373,169,5605,197,6168
13113023001,渋谷区,西原１丁目,3948,147,1849,40,2099,107,2350
13113023002,渋谷区,西原２丁目,4308,121,2237,80,2071,41,2368
13113023003,渋谷区,西原３丁目,2722,98,1287,49,1435,49,1450
131130240,渋谷区,元代々木町,3437,60,1581,38,1856,22,2062
131130250,渋谷区,大山町,2872,105,1383,58,1489,47,1503
131130260,渋谷区,初台,8290,171,3985,92,4305,79,4908
13113026001,渋谷区,初台１丁目,4449,91,2118,49,2331,42,2719
13113026002,渋谷区,初台２丁目,3841,80,1867,43,1974,37,2189
131130270,渋谷区,本町,26782,676,13502,335,13280,341,16945
13113027001,渋谷区,本町１丁目,5481,171,2719,84,2762,87,3672
13113027002,渋谷区,本町２丁目,4543,105,2243,53,2300,52,2820
13113027003,渋谷区,本町３丁目,4419,148,2254,70,2165,78,2909
13113027004,渋谷区,本町４丁目,4557,112,2312,64,2245,48,2773
13113027005,渋谷区,本町５丁目,3853,58,1976,28,1877,30,2215
13113027006,渋谷区,本町６丁目,3929,82,1998,36,1931,46,2556
131130280,渋谷区,笹塚,16531,307,7933,140,8598,167,10917
13113028001,渋谷区,笹塚１丁目,6363,100,2996,41,3367,59,4162
13113028002,渋谷区,笹塚２丁目,5972,129,2927,59,3045,70,4181
13113028003,渋谷区,笹塚３丁目,4196,78,2010,40,2186,38,2574
131130290,渋谷区,幡ケ谷,16269,291,7738,143,8531,148,9867
13113029001,渋谷区,幡ケ谷１丁目,3643,72,1668,40,1975,32,2385
13113029002,渋谷区,幡ケ谷２丁目,6645,131,3098,56,3547,75,4015
13113029003,渋谷区,幡ケ谷３丁目,5981,88,2972,47,3009,41,3467
131130300,渋谷区,代々木,23111,800,11322,445,11789,355,13904
13113030001,渋谷区,代々木１丁目,2966,84,1524,49,1442,35,1942
13113030002,渋谷区,代々木２丁目,2940,119,1473,65,1467,54,1884
13113030003,渋谷区,代々木３丁目,4716,131,2361,68,2355,63,2934
13113030004,渋谷区,代々木４丁目,6773,250,3273,136,3500,114,4009
13113030005,渋谷区,代々木５丁目,5716,216,2691,127,3025,89,3135
131130310,渋谷区,千駄ケ谷,10156,361,4938,203,5218,158,6134
13113031001,渋谷区,千駄ケ谷１丁目,1867,67,896,40,971,27,970
13113031002,渋谷区,千駄ケ谷２丁目,1029,23,502,13,527,10,603
13113031003,渋谷区,千駄ケ谷３丁目,3149,104,1543,56,1606,48,1911
13113031004,渋谷区,千駄ケ谷４丁目,1656,101,815,63,841,38,1118
13113031005,渋谷区,千駄ケ谷５丁目,2441,66,1176,31,1265,35,1525
13113031006,渋谷区,千駄ケ谷６丁目,14,0,6,0,8,0,7
131130320,渋谷区,神宮前,12059,466,5694,262,6365,204,6605
13113032001,渋谷区,神宮前１丁目,1933,54,956,30,977,24,1026
13113032002,渋谷区,神宮前２丁目,3100,107,1466,66,1634,41,1804
13113032003,渋谷区,神宮前３丁目,3068,114,1462,68,1606,46,1729
13113032004,渋谷区,神宮前４丁目,1163,58,541,34,622,24,656
13113032005,渋谷区,神宮前５丁目,1863,117,858,57,1005,60,944
13113032006,渋谷区,神宮前６丁目,932,16,411,7,521,9,446
13114,中野区,,328215,10305,165382,5232,162833,5073,196132
131140010,中野区,南台,20217,373,10140,195,10077,178,11500
13114001001,中野区,南台１丁目,1290,29,646,13,644,16,776
13114001002,中野区,南台２丁目,5346,121,2643,77,2703,44,3110
13114001003,中野区,南台３丁目,5294,87,2628,44,2666,43,2875
13114001004,中野区,南台４丁目,4025,52,2027,16,1998,36,2310
13114001005,中野区,南台５丁目,4262,84,2196,45,2066,39,2429
131140020,中野区,弥生町,22562,591,11251,284,11311,307,13574
13114002001,中野区,弥生町１丁目,6408,199,3354,106,3054,93,4017
13114002002,中野区,弥生町２丁目,5005,171,2463,90,2542,81,3138
13114002003,中野区,弥生町３丁目,2948,63,1485,22,1463,41,1792
13114002004,中野区,弥生町４丁目,3270,48,1571,21,1699,27,1863
13114002005,中野区,弥生町５丁目,3220,66,1577,25,1643,41,1813
13114002006,中野区,弥生町６丁目,1711,44,801,20,910,24,951
131140030,中野区,本町,29410,894,14563,468,14847,426,18638
13114003001,中野区,本町１丁目,3735,92,1857,43,1878,49,2320
13114003002,中野区,本町２丁目,4599,142,2370,89,2229,53,2912
13114003003,中野区,本町３丁目,5567,217,2791,95,2776,122,3596
13114003004,中野区,本町４丁目,6953,184,3383,106,3570,78,4440
13114003005,中野区,本町５丁目,3750,112,1821,64,1929,48,2398
13114003006,中野区,本町６丁目,4806,147,2341,71,2465,76,2972
131140040,中野区,中央,29189,1013,14857,523,14332,490,18460
13114004001,中野区,中央１丁目,5672,234,2861,133,2811,101,3618
13114004002,中野区,中央２丁目,6397,183,3292,90,3105,93,4037
13114004003,中野区,中央３丁目,5370,182,2772,108,2598,74,3456
13114004004,中野区,中央４丁目,6516,239,3321,104,3195,135,4137
13114004005,中野区,中央５丁目,5234,175,2611,88,2623,87,3212
131140050,中野区,東中野,23275,1032,11565,561,11710,471,14688
13114005001,中野区,東中野１丁目,6586,300,3312,172,3274,128,4237
13114005002,中野区,東中野２丁目,4455,147,2132,78,2323,69,2679
13114005003,中野区,東中野３丁目,3203,158,1586,89,1617,69,2045
13114005004,中野区,東中野４丁目,4088,229,2020,118,2068,111,2757
13114005005,中野区,東中野５丁目,4943,198,2515,104,2428,94,2970
131140060,中野区,中野,27022,1175,14146,634,12876,541,17113
13114006001,中野区,中野１丁目,5915,229,3151,136,2764,93,3555
13114006002,中野区,中野２丁目,2593,51,1300,25,1293,26,1517
13114006003,中野区,中野３丁目,5984,178,3161,98,2823,80,3769
13114006004,中野区,中野４丁目,2266,360,1171,181,1095,179,1743
13114006005,中野区,中野５丁目,6562,243,3475,131,3087,112,4361
13114006006,中野区,中野６丁目,3702,114,1888,63,1814,51,2168
131140070,中野区,上高田,20809,684,10765,338,10044,346,13014
13114007001,中野区,上高田１丁目,5556,187,2838,94,2718,93,3386
13114007002,中野区,上高田２丁目,5084,140,2723,68,2361,72,3372
13114007003,中野区,上高田３丁目,3314,108,1732,59,1582,49,2108
13114007004,中野区,上高田４丁目,3770,132,1899,59,1871,73,2262
13114007005,中野区,上高田５丁目,3085,117,1573,58,1512,59,1886
131140080,中野区,新井,18225,489,9432,238,8793,251,11256
13114008001,中野区,新井１丁目,4306,141,2251,79,2055,62,2896
13114008002,中野区,新井２丁目,5359,173,2803,77,2556,96,3310
13114008003,中野区,新井３丁目,2971,65,1584,36,1387,29,1623
13114008004,中野区,新井４丁目,3113,57,1529,23,1584,34,1822
13114008005,中野区,新井５丁目,2476,53,1265,23,1211,30,1605
131140090,中野区,沼袋,13506,497,6876,248,6630,249,8314
13114009001,中野区,沼袋１丁目,3418,134,1760,68,1658,66,2145
13114009002,中野区,沼袋２丁目,3426,124,1734,61,1692,63,2113
13114009003,中野区,沼袋３丁目,3203,148,1664,81,1539,67,2040
13114009004,中野区,沼袋４丁目,3459,91,1718,38,1741,53,2016
131140100,中野区,松が丘,6410,161,3300,83,3110,78,3774
13114010001,中野区,松が丘１丁目,3278,105,1683,53,1595,52,1978
13114010002,中野区,松が丘２丁目,3132,56,1617,30,1515,26,1796
131140110,中野区,江原町,8952,207,4418,88,4534,119,4910
13114011001,中野区,江原町１丁目,3233,81,1544,38,1689,43,1673
13114011002,中野区,江原町２丁目,3346,75,1665,27,1681,48,1813
13114011003,中野区,江原町３丁目,2373,51,1209,23,1164,28,1424
131140120,中野区,江古田,12038,310,5872,173,6166,137,6158
13114012001,中野区,江古田１丁目,3249,40,1644,24,1605,16,1636
13114012002,中野区,江古田２丁目,2580,63,1235,36,1345,27,1371
13114012003,中野区,江古田３丁目,1673,33,708,13,965,20,627
13114012004,中野区,江古田４丁目,4536,174,2285,100,2251,74,2524
131140130,中野区,丸山,5010,144,2480,79,2530,65,2763
13114013001,中野区,丸山１丁目,2043,61,1000,36,1043,25,1118
13114013002,中野区,丸山２丁目,2967,83,1480,43,1487,40,1645
131140140,中野区,野方,21095,720,10710,328,10385,392,12821
13114014001,中野区,野方１丁目,4903,132,2553,55,2350,77,3009
13114014002,中野区,野方２丁目,4938,167,2568,83,2370,84,2819
13114014003,中野区,野方３丁目,2657,115,1374,52,1283,63,1586
13114014004,中野区,野方４丁目,3263,114,1621,43,1642,71,2011
13114014005,中野区,野方５丁目,2128,85,1030,42,1098,43,1305
13114014006,中野区,野方６丁目,3206,107,1564,53,1642,54,2091
131140150,中野区,大和町,15630,577,8161,303,7469,274,9566
13114015001,中野区,大和町１丁目,5095,292,2661,154,2434,138,3335
13114015002,中野区,大和町２丁目,3226,87,1715,46,1511,41,1984
13114015003,中野区,大和町３丁目,3542,104,1844,53,1698,51,2250
13114015004,中野区,大和町４丁目,3767,94,1941,50,1826,44,1997
131140160,中野区,若宮,12868,365,6501,178,6367,187,7646
13114016001,中野区,若宮１丁目,4081,140,2104,69,1977,71,2501
13114016002,中野区,若宮２丁目,4031,93,2062,50,1969,43,2246
13114016003,中野区,若宮３丁目,4756,132,2335,59,2421,73,2899
131140170,中野区,白鷺,11371,363,5401,171,5970,192,5911
13114017001,中野区,白鷺１丁目,4083,103,1903,41,2180,62,2091
13114017002,中野区,白鷺２丁目,4164,136,1995,68,2169,68,2198
13114017003,中野区,白鷺３丁目,3124,124,1503,62,1621,62,1622
131140180,中野区,鷺宮,16782,430,8301,206,8481,224,9467
13114018001,中野区,鷺宮１丁目,2679,89,1345,41,1334,48,1684
13114018002,中野区,鷺宮２丁目,1486,28,723,14,763,14,876
13114018003,中野区,鷺宮３丁目,3579,105,1801,58,1778,47,2135
13114018004,中野区,鷺宮４丁目,3085,86,1521,37,1564,49,1814
13114018005,中野区,鷺宮５丁目,2416,44,1206,17,1210,27,1200
13114018006,中野区,鷺宮６丁目,3537,78,1705,39,1832,39,1758
131140190,中野区,上鷺宮,13844,280,6643,134,7201,146,6559
13114019001,中野区,上鷺宮１丁目,2284,37,1128,17,1156,20,1149
13114019002,中野区,上鷺宮２丁目,2783,62,1365,28,1418,34,1328
13114019003,中野区,上鷺宮３丁目,2538,42,1181,17,1357,25,1152
13114019004,中野区,上鷺宮４丁目,2485,69,1162,31,1323,38,1256
13114019005,中野区,上鷺宮５丁目,3754,70,1807,41,1947,29,1674
13115,杉並区,,563997,9847,271737,4855,292260,4992,312001
131150010,杉並区,方南,12473,211,6225,110,6248,101,7516
13115001001,杉並区,方南１丁目,7920,125,4050,69,3870,56,4805
13115001002,杉並区,方南２丁目,4553,86,2175,41,2378,45,2711
131150020,杉並区,和泉,27682,539,13528,244,14154,295,15795
13115002001,杉並区,和泉１丁目,5796,107,2892,53,2904,54,3752
13115002002,杉並区,和泉２丁目,7227,193,3624,87,3603,106,4133
13115002003,杉並区,和泉３丁目,6718,76,3199,35,3519,41,3687
13115002004,杉並区,和泉４丁目,7941,163,3813,69,4128,94,4223
131150030,杉並区,下高井戸,19884,344,9665,179,10219,165,11482
13115003001,杉並区,下高井戸１丁目,4731,130,2285,65,2446,65,3285
13115003002,杉並区,下高井戸２丁目,3168,70,1529,37,1639,33,1997
13115003003,杉並区,下高井戸３丁目,3643,55,1797,27,1846,28,2020
13115003004,杉並区,下高井戸４丁目,5400,64,2609,39,2791,25,2713
13115003005,杉並区,下高井戸５丁目,2942,25,1445,11,1497,14,1467
131150040,杉並区,永福,15304,241,7251,102,8053,139,8518
13115004001,杉並区,永福１丁目,3214,55,1597,27,1617,28,1812
13115004002,杉並区,永福２丁目,4493,44,2083,18,2410,26,2342
13115004003,杉並区,永福３丁目,3979,75,1861,29,2118,46,2262
13115004004,杉並区,永福４丁目,3618,67,1710,28,1908,39,2102
131150050,杉並区,浜田山,16883,148,8000,85,8883,63,8688
13115005001,杉並区,浜田山１丁目,3951,41,1874,22,2077,19,1993
13115005002,杉並区,浜田山２丁目,2793,22,1377,13,1416,9,1499
13115005003,杉並区,浜田山３丁目,4305,34,1983,17,2322,17,2247
13115005004,杉並区,浜田山４丁目,5834,51,2766,33,3068,18,2949
131150060,杉並区,和田,20145,428,9489,172,10656,256,11350
13115006001,杉並区,和田１丁目,9202,237,4238,77,4964,160,5068
13115006002,杉並区,和田２丁目,4140,63,1989,31,2151,32,2215
13115006003,杉並区,和田３丁目,6803,128,3262,64,3541,64,4067
131150070,杉並区,堀ノ内,19375,318,9543,164,9832,154,10769
13115007001,杉並区,堀ノ内１丁目,4787,72,2322,38,2465,34,2701
13115007002,杉並区,堀ノ内２丁目,7434,91,3683,50,3751,41,3793
13115007003,杉並区,堀ノ内３丁目,7154,155,3538,76,3616,79,4275
131150080,杉並区,松ノ木,7698,112,3776,49,3922,63,4147
13115008001,杉並区,松ノ木１丁目,2075,47,1057,22,1018,25,1046
13115008002,杉並区,松ノ木２丁目,2709,32,1316,14,1393,18,1401
13115008003,杉並区,松ノ木３丁目,2914,33,1403,13,1511,20,1700
131150090,杉並区,大宮,3762,58,1865,30,1897,28,2030
13115009001,杉並区,大宮１丁目,2287,40,1160,17,1127,23,1232
13115009002,杉並区,大宮２丁目,1475,18,705,13,770,5,798
131150100,杉並区,梅里,8320,234,3982,106,4338,128,5270
13115010001,杉並区,梅里１丁目,3236,89,1530,44,1706,45,2104
13115010002,杉並区,梅里２丁目,5084,145,2452,62,2632,83,3166
131150110,杉並区,高円寺南,32316,893,16407,474,15909,419,21454
13115011001,杉並区,高円寺南１丁目,6389,183,3195,95,3194,88,4242
13115011002,杉並区,高円寺南２丁目,7210,154,3539,79,3671,75,4949
13115011003,杉並区,高円寺南３丁目,7879,235,4059,126,3820,109,5152
13115011004,杉並区,高円寺南４丁目,4414,150,2247,84,2167,66,3038
13115011005,杉並区,高円寺南５丁目,6424,171,3367,90,3057,81,4073
131150120,杉並区,高円寺北,16417,483,8378,231,8039,252,10840
13115012001,杉並区,高円寺北１丁目,2677,74,1354,44,1323,30,1521
13115012002,杉並区,高円寺北２丁目,4431,114,2227,55,2204,59,3125
13115012003,杉並区,高円寺北３丁目,5676,219,2937,98,2739,121,3947
13115012004,杉並区,高円寺北４丁目,3633,76,1860,34,1773,42,2247
131150130,杉並区,阿佐谷南,19099,503,9241,258,9858,245,12099
13115013001,杉並区,阿佐谷南１丁目,7636,194,3736,106,3900,88,4721
13115013002,杉並区,阿佐谷南２丁目,3727,104,1871,58,1856,46,2501
13115013003,杉並区,阿佐谷南３丁目,7736,205,3634,94,4102,111,4877
131150140,杉並区,阿佐谷北,24296,560,11877,287,12419,273,14246
13115014001,杉並区,阿佐谷北１丁目,4660,130,2291,69,2369,61,2790
13115014002,杉並区,阿佐谷北２丁目,4336,143,2102,76,2234,67,2792
13115014003,杉並区,阿佐谷北３丁目,4067,62,1951,35,2116,27,2393
13115014004,杉並区,阿佐谷北４丁目,4138,98,2051,48,2087,50,2464
13115014005,杉並区,阿佐谷北５丁目,3712,82,1819,39,1893,43,2066
13115014006,杉並区,阿佐谷北６丁目,3383,45,1663,20,1720,25,1741
131150150,杉並区,天沼,15632,405,7801,214,7831,191,9452
13115015001,杉並区,天沼１丁目,4128,119,2169,53,1959,66,2451
13115015002,杉並区,天沼２丁目,5305,101,2642,59,2663,42,3079
13115015003,杉並区,天沼３丁目,6199,185,2990,102,3209,83,3922
131150160,杉並区,本天沼,11291,153,5609,84,5682,69,5792
13115016001,杉並区,本天沼１丁目,3303,43,1693,27,1610,16,1823
13115016002,杉並区,本天沼２丁目,4368,69,2164,33,2204,36,2268
13115016003,杉並区,本天沼３丁目,3620,41,1752,24,1868,17,1701
131150170,杉並区,成田西,8722,102,4195,56,4527,46,3772
13115017001,杉並区,成田西１丁目,2770,41,1334,21,1436,20,1179
13115017002,杉並区,成田西２丁目,2962,37,1406,21,1556,16,1328
13115017003,杉並区,成田西３丁目,2055,11,1008,4,1047,7,849
13115017004,杉並区,成田西４丁目,935,13,447,10,488,3,416
131150180,杉並区,成田東,21199,340,10181,163,11018,177,11194
13115018001,杉並区,成田東１丁目,4653,66,2276,33,2377,33,2430
13115018002,杉並区,成田東２丁目,3393,25,1681,12,1712,13,1513
13115018003,杉並区,成田東３丁目,3251,75,1619,32,1632,43,1742
13115018004,杉並区,成田東４丁目,3979,57,1907,31,2072,26,2230
13115018005,杉並区,成田東５丁目,5923,117,2698,55,3225,62,3279
131150190,杉並区,荻窪,24329,370,11569,184,12760,186,13341
13115019001,杉並区,荻窪１丁目,5008,43,2446,22,2562,21,2411
13115019002,杉並区,荻窪２丁目,4055,71,1928,34,2127,37,2038
13115019003,杉並区,荻窪３丁目,6072,91,2946,50,3126,41,3211
13115019004,杉並区,荻窪４丁目,4228,78,1960,41,2268,37,2558
13115019005,杉並区,荻窪５丁目,4966,87,2289,37,2677,50,3123
131150200,杉並区,南荻窪,13525,227,6536,120,6989,107,7030
13115020001,杉並区,南荻窪１丁目,3609,38,1716,17,1893,21,1774
13115020002,杉並区,南荻窪２丁目,3772,49,1853,26,1919,23,1796
13115020003,杉並区,南荻窪３丁目,2776,49,1344,33,1432,16,1535
13115020004,杉並区,南荻窪４丁目,3368,91,1623,44,1745,47,1925
131150210,杉並区,上荻,12951,186,6246,84,6705,102,7643
13115021001,杉並区,上荻１丁目,1600,23,728,9,872,14,1058
13115021002,杉並区,上荻２丁目,4872,65,2428,32,2444,33,3037
13115021003,杉並区,上荻３丁目,2959,38,1444,13,1515,25,1544
13115021004,杉並区,上荻４丁目,3520,60,1646,30,1874,30,2004
131150220,杉並区,西荻南,11666,143,5332,70,6334,73,6827
13115022001,杉並区,西荻南１丁目,2493,28,1205,14,1288,14,1337
13115022002,杉並区,西荻南２丁目,3887,43,1692,15,2195,28,2429
13115022003,杉並区,西荻南３丁目,2492,41,1145,23,1347,18,1547
13115022004,杉並区,西荻南４丁目,2794,31,1290,18,1504,13,1514
131150230,杉並区,西荻北,17858,268,8274,132,9584,136,10378
13115023001,杉並区,西荻北１丁目,2458,31,1206,14,1252,17,1376
13115023002,杉並区,西荻北２丁目,4553,55,2088,26,2465,29,2460
13115023003,杉並区,西荻北３丁目,5132,118,2333,60,2799,58,3144
13115023004,杉並区,西荻北４丁目,3883,43,1765,23,2118,20,2392
13115023005,杉並区,西荻北５丁目,1832,21,882,9,950,12,1006
131150240,杉並区,今川,9508,105,4618,52,4890,53,4311
13115024001,杉並区,今川１丁目,2427,40,1190,19,1237,21,1125
13115024002,杉並区,今川２丁目,1949,19,959,9,990,10,776
13115024003,杉並区,今川３丁目,2873,26,1400,15,1473,11,1378
13115024004,杉並区,今川４丁目,2259,20,1069,9,1190,11,1032
131150250,杉並区,清水,8404,128,4005,65,4399,63,4226
13115025001,杉並区,清水１丁目,3107,61,1441,34,1666,27,1788
13115025002,杉並区,清水２丁目,1843,21,854,13,989,8,821
13115025003,杉並区,清水３丁目,3454,46,1710,18,1744,28,1617
131150260,杉並区,桃井,11856,161,5636,77,6220,84,5948
13115026001,杉並区,桃井１丁目,3785,53,1838,23,1947,30,2054
13115026002,杉並区,桃井２丁目,2662,35,1221,11,1441,24,1256
13115026003,杉並区,桃井３丁目,2877,33,1326,18,1551,15,1236
13115026004,杉並区,桃井４丁目,2532,40,1251,25,1281,15,1402
131150270,杉並区,井草,16505,326,7992,148,8513,178,8607
13115027001,杉並区,井草１丁目,4388,68,2137,30,2251,38,2336
13115027002,杉並区,井草２丁目,5877,80,2890,39,2987,41,2777
13115027003,杉並区,井草３丁目,2611,78,1217,36,1394,42,1488
13115027004,杉並区,井草４丁目,1764,61,826,24,938,37,938
13115027005,杉並区,井草５丁目,1865,39,922,19,943,20,1068
131150280,杉並区,下井草,18182,328,8889,147,9293,181,9617
13115028001,杉並区,下井草１丁目,3221,52,1608,25,1613,27,1797
13115028002,杉並区,下井草２丁目,4137,89,2046,38,2091,51,2079
13115028003,杉並区,下井草３丁目,4667,94,2238,44,2429,50,2505
13115028004,杉並区,下井草４丁目,3657,55,1782,28,1875,27,1832
13115028005,杉並区,下井草５丁目,2500,38,1215,12,1285,26,1404
131150290,杉並区,上井草,15630,252,7602,130,8028,122,7353
13115029001,杉並区,上井草１丁目,3563,69,1692,31,1871,38,1808
13115029002,杉並区,上井草２丁目,5420,80,2642,44,2778,36,2614
13115029003,杉並区,上井草３丁目,3684,62,1860,30,1824,32,1659
13115029004,杉並区,上井草４丁目,2963,41,1408,25,1555,16,1272
131150300,杉並区,善福寺,12005,135,5599,64,6406,71,5432
13115030001,杉並区,善福寺１丁目,3951,47,1851,22,2100,25,1927
13115030002,杉並区,善福寺２丁目,3758,42,1700,19,2058,23,1661
13115030003,杉並区,善福寺３丁目,2042,16,956,7,1086,9,899
13115030004,杉並区,善福寺４丁目,2254,30,1092,16,1162,14,945
131150310,杉並区,松庵,10354,115,4740,56,5614,59,5533
13115031001,杉並区,松庵１丁目,3519,18,1631,11,1888,7,1657
13115031002,杉並区,松庵２丁目,2527,27,1152,7,1375,20,1253
13115031003,杉並区,松庵３丁目,4308,70,1957,38,2351,32,2623
131150320,杉並区,宮前,18309,176,8835,83,9474,93,8812
13115032001,杉並区,宮前１丁目,1830,18,876,9,954,9,928
13115032002,杉並区,宮前２丁目,3610,33,1723,13,1887,20,1531
13115032003,杉並区,宮前３丁目,4816,63,2371,30,2445,33,2369
13115032004,杉並区,宮前４丁目,4309,34,2068,18,2241,16,2130
13115032005,杉並区,宮前５丁目,3744,28,1797,13,1947,15,1854
131150330,杉並区,久我山,19828,247,9194,111,10634,136,10597
13115033001,杉並区,久我山１丁目,1816,14,793,4,1023,10,1052
13115033002,杉並区,久我山２丁目,2581,59,1246,21,1335,38,1338
13115033003,杉並区,久我山３丁目,5109,54,2399,32,2710,22,2830
13115033004,杉並区,久我山４丁目,5147,63,2381,25,2766,38,2581
13115033005,杉並区,久我山５丁目,5175,57,2375,29,2800,28,2796
131150340,杉並区,高井戸東,19254,198,9027,102,10227,96,9666
13115034001,杉並区,高井戸東１丁目,3824,31,1794,14,2030,17,1723
13115034002,杉並区,高井戸東２丁目,3685,49,1729,25,1956,24,1993
13115034003,杉並区,高井戸東３丁目,6910,68,3243,36,3667,32,3538
13115034004,杉並区,高井戸東４丁目,4835,50,2261,27,2574,23,2412
131150350,杉並区,高井戸西,11516,132,5039,70,6477,62,5451
13115035001,杉並区,高井戸西１丁目,5776,63,2311,30,3465,33,2626
13115035002,杉並区,高井戸西２丁目,3058,50,1409,31,1649,19,1510
13115035003,杉並区,高井戸西３丁目,2682,19,1319,9,1363,10,1315
131150360,杉並区,上高井戸,11819,278,5591,152,6228,126,6815
13115036001,杉並区,上高井戸１丁目,6374,193,2956,114,3418,79,3957
13115036002,杉並区,上高井戸２丁目,3219,40,1508,17,1711,23,1558
13115036003,杉並区,上高井戸３丁目,2226,45,1127,21,1099,24,1300
13116,豊島区,,291167,22279,146827,11456,144340,10823,176376
131160010,豊島区,駒込,17963,831,8743,417,9220,414,9994
13116001001,豊島区,駒込１丁目,4236,291,2019,152,2217,139,2658
13116001002,豊島区,駒込２丁目,1939,162,874,72,1065,90,1220
13116001003,豊島区,駒込３丁目,2438,94,1227,47,1211,47,1472
13116001004,豊島区,駒込４丁目,3711,96,1741,44,1970,52,1795
13116001005,豊島区,駒込５丁目,668,19,322,11,346,8,226
13116001006,豊島区,駒込６丁目,3364,128,1700,64,1664,64,1756
13116001007,豊島区,駒込７丁目,1607,41,860,27,747,14,867
131160020,豊島区,巣鴨,19158,1110,9353,530,9805,580,11273
13116002001,豊島区,巣鴨１丁目,3900,303,1890,140,2010,163,2419
13116002002,豊島区,巣鴨２丁目,742,79,357,42,385,37,539
13116002003,豊島区,巣鴨３丁目,4863,300,2347,130,2516,170,2926
13116002004,豊島区,巣鴨４丁目,6219,305,3070,158,3149,147,3572
13116002005,豊島区,巣鴨５丁目,3434,123,1689,60,1745,63,1817
131160030,豊島区,西巣鴨,13326,778,6563,432,6763,346,7567
13116003001,豊島区,西巣鴨１丁目,4923,331,2478,157,2445,174,2693
13116003002,豊島区,西巣鴨２丁目,4298,345,2155,225,2143,120,2402
13116003003,豊島区,西巣鴨３丁目,2437,56,1108,24,1329,32,1387
13116003004,豊島区,西巣鴨４丁目,1668,46,822,26,846,20,1085
131160040,豊島区,北大塚,11845,1527,5937,794,5908,733,7617
13116004001,豊島区,北大塚１丁目,3795,341,1845,184,1950,157,2251
13116004002,豊島区,北大塚２丁目,3748,550,1841,256,1907,294,2497
13116004003,豊島区,北大塚３丁目,4302,636,2251,354,2051,282,2869
131160050,豊島区,南大塚,16487,1577,8151,787,8336,790,10390
13116005001,豊島区,南大塚１丁目,6478,730,3354,379,3124,351,4126
13116005002,豊島区,南大塚２丁目,5537,466,2690,243,2847,223,3324
13116005003,豊島区,南大塚３丁目,4472,381,2107,165,2365,216,2940
131160060,豊島区,上池袋,17953,1514,9300,783,8653,731,11003
13116006001,豊島区,上池袋１丁目,5219,599,2624,310,2595,289,3307
13116006002,豊島区,上池袋２丁目,3482,253,1898,124,1584,129,2231
13116006003,豊島区,上池袋３丁目,4469,369,2384,198,2085,171,2841
13116006004,豊島区,上池袋４丁目,4783,293,2394,151,2389,142,2624
131160070,豊島区,東池袋,20395,2318,10723,1169,9672,1149,13478
13116007001,豊島区,東池袋１丁目,1136,262,659,136,477,126,899
13116007002,豊島区,東池袋２丁目,6783,1012,3694,525,3089,487,4865
13116007003,豊島区,東池袋３丁目,3349,429,1856,205,1493,224,2200
13116007004,豊島区,東池袋４丁目,4517,262,2231,128,2286,134,2486
13116007005,豊島区,東池袋５丁目,4610,353,2283,175,2327,178,3028
131160080,豊島区,南池袋,8630,578,4400,310,4230,268,5307
13116008001,豊島区,南池袋１丁目,2073,260,1106,141,967,119,1483
13116008002,豊島区,南池袋２丁目,2967,157,1496,84,1471,73,1743
13116008003,豊島区,南池袋３丁目,2187,106,1049,66,1138,40,1217
13116008004,豊島区,南池袋４丁目,1403,55,749,19,654,36,864
131160090,豊島区,西池袋,17101,1553,8767,797,8334,756,11249
13116009001,豊島区,西池袋１丁目,318,54,197,29,121,25,239
13116009002,豊島区,西池袋２丁目,4224,370,2221,194,2003,176,2718
13116009003,豊島区,西池袋３丁目,3665,385,1883,185,1782,200,2422
13116009004,豊島区,西池袋４丁目,5093,416,2607,227,2486,189,3362
13116009005,豊島区,西池袋５丁目,3801,328,1859,162,1942,166,2508
131160100,豊島区,池袋,20131,3987,10841,2053,9290,1934,13741
13116010001,豊島区,池袋１丁目,2587,595,1405,332,1182,263,1723
13116010002,豊島区,池袋２丁目,6353,1440,3320,684,3033,756,4472
13116010003,豊島区,池袋３丁目,7548,1152,4121,613,3427,539,5076
13116010004,豊島区,池袋４丁目,3643,800,1995,424,1648,376,2470
131160110,豊島区,池袋本町,18808,1467,9773,779,9035,688,10724
13116011001,豊島区,池袋本町１丁目,3822,504,2095,293,1727,211,2472
13116011002,豊島区,池袋本町２丁目,3747,417,2019,211,1728,206,2252
13116011003,豊島区,池袋本町３丁目,3405,251,1751,128,1654,123,2001
13116011004,豊島区,池袋本町４丁目,7834,295,3908,147,3926,148,3999
131160120,豊島区,雑司が谷,9630,451,4647,215,4983,236,5731
13116012001,豊島区,雑司が谷１丁目,4017,158,1919,79,2098,79,2253
13116012002,豊島区,雑司が谷２丁目,3261,135,1547,54,1714,81,1909
13116012003,豊島区,雑司が谷３丁目,2352,158,1181,82,1171,76,1569
131160130,豊島区,高田,11792,1258,5904,676,5888,582,7010
13116013001,豊島区,高田１丁目,3904,365,2032,207,1872,158,2434
13116013002,豊島区,高田２丁目,4017,301,1973,151,2044,150,2291
13116013003,豊島区,高田３丁目,3871,592,1899,318,1972,274,2285
131160140,豊島区,目白,14433,782,6808,384,7625,398,8131
13116014001,豊島区,目白１丁目,1311,32,577,11,734,21,598
13116014002,豊島区,目白２丁目,3502,176,1596,70,1906,106,2051
13116014003,豊島区,目白３丁目,2495,233,1102,117,1393,116,1450
13116014004,豊島区,目白４丁目,3705,169,1826,87,1879,82,1987
13116014005,豊島区,目白５丁目,3420,172,1707,99,1713,73,2045
131160150,豊島区,南長崎,20312,625,10277,329,10035,296,12157
13116015001,豊島区,南長崎１丁目,3151,128,1554,64,1597,64,1893
13116015002,豊島区,南長崎２丁目,2768,88,1354,42,1414,46,1652
13116015003,豊島区,南長崎３丁目,4022,147,2066,71,1956,76,2328
13116015004,豊島区,南長崎４丁目,3423,109,1756,60,1667,49,1943
13116015005,豊島区,南長崎５丁目,3511,72,1756,41,1755,31,2261
13116015006,豊島区,南長崎６丁目,3437,81,1791,51,1646,30,2080
131160160,豊島区,長崎,18740,590,9500,334,9240,256,11120
13116016001,豊島区,長崎１丁目,2724,109,1404,60,1320,49,1680
13116016002,豊島区,長崎２丁目,3606,165,1914,93,1692,72,2260
13116016003,豊島区,長崎３丁目,2628,61,1320,28,1308,33,1471
13116016004,豊島区,長崎４丁目,4043,134,1985,86,2058,48,2357
13116016005,豊島区,長崎５丁目,2971,66,1508,37,1463,29,1823
13116016006,豊島区,長崎６丁目,2768,55,1369,30,1399,25,1529
131160170,豊島区,千早,12516,466,6282,226,6234,240,7145
13116017001,豊島区,千早１丁目,3548,186,1804,97,1744,89,2247
13116017002,豊島区,千早２丁目,4181,157,2111,77,2070,80,2361
13116017003,豊島区,千早３丁目,2441,46,1223,21,1218,25,1215
13116017004,豊島区,千早４丁目,2346,77,1144,31,1202,46,1322
131160180,豊島区,要町,9471,408,4668,188,4803,220,5765
13116018001,豊島区,要町１丁目,3954,254,2064,118,1890,136,2520
13116018002,豊島区,要町２丁目,2152,74,1013,34,1139,40,1282
13116018003,豊島区,要町３丁目,3365,80,1591,36,1774,44,1963
131160190,豊島区,高松,8068,381,4108,215,3960,166,4573
13116019001,豊島区,高松１丁目,1713,113,891,64,822,49,1079
13116019002,豊島区,高松２丁目,3958,194,2051,115,1907,79,2277
13116019003,豊島区,高松３丁目,2397,74,1166,36,1231,38,1217
131160200,豊島区,千川,4408,78,2082,38,2326,40,2401
13116020001,豊島区,千川１丁目,2034,41,950,22,1084,19,1136
13116020002,豊島区,千川２丁目,2374,37,1132,16,1242,21,1265
13117,北区,,341076,15152,169829,7351,171247,7801,178379
131170010,北区,王子,20214,901,9915,399,10299,502,10753
13117001001,北区,王子１丁目,2728,139,1307,53,1421,86,1519
13117001002,北区,王子２丁目,2766,107,1417,43,1349,64,1575
13117001003,北区,王子３丁目,2762,102,1340,43,1422,59,1563
13117001004,北区,王子４丁目,2881,89,1484,47,1397,42,1505
13117001005,北区,王子５丁目,7260,447,3475,207,3785,240,3832
13117001006,北区,王子６丁目,1817,17,892,6,925,11,759
131170020,北区,豊島,31403,1760,15644,856,15759,904,15591
13117002001,北区,豊島１丁目,3566,311,1824,165,1742,146,1881
13117002002,北区,豊島２丁目,1885,74,989,35,896,39,1059
13117002003,北区,豊島３丁目,2669,39,1314,13,1355,26,1318
13117002004,北区,豊島４丁目,2333,69,1142,36,1191,33,1059
13117002005,北区,豊島５丁目,10523,1006,5146,487,5377,519,5502
13117002006,北区,豊島６丁目,1097,33,569,13,528,20,527
13117002007,北区,豊島７丁目,4240,60,2082,23,2158,37,1892
13117002008,北区,豊島８丁目,5090,168,2578,84,2512,84,2353
131170030,北区,堀船,9716,392,4813,193,4903,199,4939
13117003001,北区,堀船１丁目,2406,108,1208,52,1198,56,1292
13117003002,北区,堀船２丁目,3141,183,1561,97,1580,86,1571
13117003003,北区,堀船３丁目,3304,80,1638,36,1666,44,1645
13117003004,北区,堀船４丁目,865,21,406,8,459,13,431
131170040,北区,東十条,14369,973,7427,505,6942,468,8257
13117004001,北区,東十条１丁目,2477,160,1323,78,1154,82,1427
13117004002,北区,東十条２丁目,2427,136,1255,69,1172,67,1447
13117004003,北区,東十条３丁目,3378,359,1663,189,1715,170,1916
13117004004,北区,東十条４丁目,2398,171,1232,89,1166,82,1458
13117004005,北区,東十条５丁目,2166,111,1151,58,1015,53,1219
13117004006,北区,東十条６丁目,1523,36,803,22,720,14,790
131170050,北区,王子本町,5538,179,2702,85,2836,94,3108
13117005001,北区,王子本町１丁目,2398,91,1194,45,1204,46,1272
13117005002,北区,王子本町２丁目,1965,54,974,27,991,27,1117
13117005003,北区,王子本町３丁目,1175,34,534,13,641,21,719
131170060,北区,岸町,2681,138,1355,81,1326,57,1500
13117006001,北区,岸町１丁目,1211,40,531,21,680,19,597
13117006002,北区,岸町２丁目,1470,98,824,60,646,38,903
131170070,北区,中十条,8708,403,4314,230,4394,173,5100
13117007001,北区,中十条１丁目,2469,100,1241,62,1228,38,1449
13117007002,北区,中十条２丁目,2040,93,1024,59,1016,34,1256
13117007003,北区,中十条３丁目,3079,175,1522,90,1557,85,1861
13117007004,北区,中十条４丁目,1120,35,527,19,593,16,534
131170080,北区,十条台,1358,13,785,6,573,7,413
13117008001,北区,十条台１丁目,973,12,568,6,405,6,267
13117008002,北区,十条台２丁目,385,1,217,0,168,1,146
131170090,北区,十条仲原,6006,133,2902,67,3104,66,3156
13117009001,北区,十条仲原１丁目,1937,47,934,24,1003,23,1089
13117009002,北区,十条仲原２丁目,1427,40,667,20,760,20,775
13117009003,北区,十条仲原３丁目,1321,23,657,11,664,12,637
13117009004,北区,十条仲原４丁目,1321,23,644,12,677,11,655
131170100,北区,上十条,12848,459,6368,224,6480,235,7271
13117010001,北区,上十条１丁目,2989,109,1428,44,1561,65,1760
13117010002,北区,上十条２丁目,2020,88,1006,51,1014,37,1194
13117010003,北区,上十条３丁目,2488,83,1243,43,1245,40,1516
13117010004,北区,上十条４丁目,2270,97,1119,51,1151,46,1210
13117010005,北区,上十条５丁目,3081,82,1572,35,1509,47,1591
131170110,北区,神谷,15333,501,7632,230,7701,271,7734
13117011001,北区,神谷１丁目,5684,258,2783,123,2901,135,2813
13117011002,北区,神谷２丁目,4236,162,2178,77,2058,85,2195
13117011003,北区,神谷３丁目,5413,81,2671,30,2742,51,2726
131170120,北区,赤羽,10494,656,5413,302,5081,354,5817
13117012001,北区,赤羽１丁目,3357,272,1754,132,1603,140,2006
13117012002,北区,赤羽２丁目,4845,293,2499,132,2346,161,2663
13117012003,北区,赤羽３丁目,2292,91,1160,38,1132,53,1148
131170130,北区,西が丘,8478,272,4268,135,4210,137,4005
13117013001,北区,西が丘１丁目,3338,91,1668,45,1670,46,1629
13117013002,北区,西が丘２丁目,1821,79,926,40,895,39,880
13117013003,北区,西が丘３丁目,3319,102,1674,50,1645,52,1496
131170140,北区,赤羽西,16285,580,8179,254,8106,326,8577
13117014001,北区,赤羽西１丁目,3602,156,1821,75,1781,81,2096
13117014002,北区,赤羽西２丁目,2313,55,1189,25,1124,30,1192
13117014003,北区,赤羽西３丁目,2208,90,1115,39,1093,51,1169
13117014004,北区,赤羽西４丁目,3520,136,1805,69,1715,67,1803
13117014005,北区,赤羽西５丁目,1326,35,539,7,787,28,641
13117014006,北区,赤羽西６丁目,3316,108,1710,39,1606,69,1676
131170150,北区,志茂,18942,436,9632,203,9310,233,9848
13117015001,北区,志茂１丁目,3080,65,1516,24,1564,41,1602
13117015002,北区,志茂２丁目,5083,135,2629,69,2454,66,2820
13117015003,北区,志茂３丁目,3259,59,1585,24,1674,35,1478
13117015004,北区,志茂４丁目,3998,81,2066,34,1932,47,2089
13117015005,北区,志茂５丁目,3522,96,1836,52,1686,44,1859
131170160,北区,岩淵町,4622,116,2358,50,2264,66,2450
131170170,北区,赤羽台,8784,264,4160,124,4624,140,4379
13117017001,北区,赤羽台１丁目,1245,56,568,31,677,25,719
13117017002,北区,赤羽台２丁目,3337,101,1576,47,1761,54,1604
13117017003,北区,赤羽台３丁目,2659,77,1350,31,1309,46,1400
13117017004,北区,赤羽台４丁目,1543,30,666,15,877,15,656
131170180,北区,赤羽南,4799,275,2398,151,2401,124,2563
13117018001,北区,赤羽南１丁目,3455,213,1709,114,1746,99,1858
13117018002,北区,赤羽南２丁目,1344,62,689,37,655,25,705
131170190,北区,赤羽北,14915,709,7219,346,7696,363,6883
13117019001,北区,赤羽北１丁目,3663,130,1782,61,1881,69,1744
13117019002,北区,赤羽北２丁目,6153,425,3005,218,3148,207,3028
13117019003,北区,赤羽北３丁目,5099,154,2432,67,2667,87,2111
131170200,北区,浮間,23226,1235,11511,571,11715,664,10587
13117020001,北区,浮間１丁目,3467,164,1683,77,1784,87,1491
13117020002,北区,浮間２丁目,5670,215,2867,97,2803,118,2580
13117020003,北区,浮間３丁目,8791,630,4233,299,4558,331,4121
13117020004,北区,浮間４丁目,3243,116,1711,53,1532,63,1588
13117020005,北区,浮間５丁目,2055,110,1017,45,1038,65,807
131170210,北区,桐ヶ丘,6218,178,2606,69,3612,109,3337
13117021001,北区,桐ヶ丘１丁目,4531,119,1907,53,2624,66,2364
13117021002,北区,桐ヶ丘２丁目,1687,59,699,16,988,43,973
131170220,北区,滝野川,34285,1220,16981,598,17304,622,18009
13117022001,北区,滝野川１丁目,5709,159,2795,72,2914,87,2994
13117022002,北区,滝野川２丁目,4652,106,2326,51,2326,55,2300
13117022003,北区,滝野川３丁目,6408,221,3074,100,3334,121,3204
13117022004,北区,滝野川４丁目,1859,45,998,23,861,22,1032
13117022005,北区,滝野川５丁目,3142,124,1642,70,1500,54,1767
13117022006,北区,滝野川６丁目,6780,236,3315,130,3465,106,3478
13117022007,北区,滝野川７丁目,5735,329,2831,152,2904,177,3234
131170230,北区,西ヶ原,17305,533,8436,264,8869,269,8674
13117023001,北区,西ヶ原１丁目,5072,212,2396,111,2676,101,2748
13117023002,北区,西ヶ原２丁目,2616,50,1326,19,1290,31,1285
13117023003,北区,西ヶ原３丁目,4652,112,2250,47,2402,65,2208
13117023004,北区,西ヶ原４丁目,4965,159,2464,87,2501,72,2433
131170240,北区,栄町,2324,60,1225,32,1099,28,1239
131170250,北区,上中里,6532,321,3309,166,3223,155,3395
13117025001,北区,上中里１丁目,2700,118,1309,61,1391,57,1320
13117025002,北区,上中里２丁目,2569,130,1326,63,1243,67,1431
13117025003,北区,上中里３丁目,1263,73,674,42,589,31,644
131170260,北区,中里,6835,413,3501,212,3334,201,4037
13117026001,北区,中里１丁目,1933,135,972,63,961,72,1198
13117026002,北区,中里２丁目,1781,121,920,66,861,55,1172
13117026003,北区,中里３丁目,3121,157,1609,83,1512,74,1667
131170270,北区,昭和町,2940,134,1509,62,1431,72,1559
13117027001,北区,昭和町１丁目,1054,49,570,21,484,28,613
13117027002,北区,昭和町２丁目,1552,71,771,35,781,36,769
13117027003,北区,昭和町３丁目,334,14,168,6,166,8,177
131170280,北区,田端新町,8277,912,4266,445,4011,467,5049
13117028001,北区,田端新町１丁目,3263,513,1650,259,1613,254,1999
13117028002,北区,田端新町２丁目,2207,193,1190,103,1017,90,1369
13117028003,北区,田端新町３丁目,2807,206,1426,83,1381,123,1681
131170290,北区,東田端,3442,217,1825,107,1617,110,1962
13117029001,北区,東田端１丁目,1573,117,873,61,700,56,893
13117029002,北区,東田端２丁目,1869,100,952,46,917,54,1069
131170300,北区,田端,14199,769,7176,384,7023,385,8187
13117030001,北区,田端１丁目,4919,277,2520,132,2399,145,2764
13117030002,北区,田端２丁目,1680,122,847,72,833,50,1023
13117030003,北区,田端３丁目,3252,116,1635,53,1617,63,1833
13117030004,北区,田端４丁目,1407,70,667,29,740,41,814
13117030005,北区,田端５丁目,1784,90,912,44,872,46,1036
13117030006,北区,田端６丁目,1157,94,595,54,562,40,717
13118,荒川区,,212264,14576,105113,7017,107151,7559,103101
131180010,荒川区,南千住,46256,2696,22973,1247,23283,1449,20389
13118001001,荒川区,南千住１丁目,3675,160,1827,71,1848,89,1847
13118001002,荒川区,南千住２丁目,2668,178,1450,87,1218,91,1641
13118001003,荒川区,南千住３丁目,5378,359,2775,163,2603,196,2308
13118001004,荒川区,南千住４丁目,3959,366,1899,173,2060,193,1752
13118001005,荒川区,南千住５丁目,4509,192,2264,95,2245,97,2365
13118001006,荒川区,南千住６丁目,8030,306,3927,139,4103,167,3278
13118001007,荒川区,南千住７丁目,6264,362,3181,169,3083,193,2913
13118001008,荒川区,南千住８丁目,11773,773,5650,350,6123,423,4285
131180020,荒川区,荒川,32081,2001,15898,947,16183,1054,15758
13118002001,荒川区,荒川１丁目,4780,268,2367,132,2413,136,2337
13118002002,荒川区,荒川２丁目,2844,158,1429,75,1415,83,1377
13118002003,荒川区,荒川３丁目,6014,762,2986,376,3028,386,2975
13118002004,荒川区,荒川４丁目,4227,180,2127,84,2100,96,2162
13118002005,荒川区,荒川５丁目,3625,214,1789,100,1836,114,1873
13118002006,荒川区,荒川６丁目,4141,127,2077,57,2064,70,2117
13118002007,荒川区,荒川７丁目,4198,203,2012,82,2186,121,2044
13118002008,荒川区,荒川８丁目,2252,89,1111,41,1141,48,873
131180030,荒川区,町屋,29233,1143,14301,520,14932,623,13616
13118003001,荒川区,町屋１丁目,3642,202,1825,98,1817,104,1801
13118003002,荒川区,町屋２丁目,2563,87,1218,46,1345,41,1399
13118003003,荒川区,町屋３丁目,3967,208,1941,84,2026,124,2079
13118003004,荒川区,町屋４丁目,3914,106,1941,44,1973,62,1804
13118003005,荒川区,町屋５丁目,3755,135,1839,59,1916,76,1582
13118003006,荒川区,町屋６丁目,4593,155,2196,71,2397,84,2094
13118003007,荒川区,町屋７丁目,3921,116,1939,55,1982,61,1527
13118003008,荒川区,町屋８丁目,2878,134,1402,63,1476,71,1330
131180040,荒川区,東尾久,26897,1278,13361,633,13536,645,13194
13118004001,荒川区,東尾久１丁目,4081,347,2094,195,1987,152,2026
13118004002,荒川区,東尾久２丁目,4522,150,2275,65,2247,85,2206
13118004003,荒川区,東尾久３丁目,3161,94,1551,41,1610,53,1542
13118004004,荒川区,東尾久４丁目,4380,262,2152,123,2228,139,2321
13118004005,荒川区,東尾久５丁目,3063,143,1530,77,1533,66,1451
13118004006,荒川区,東尾久６丁目,4344,88,2126,38,2218,50,2110
13118004007,荒川区,東尾久７丁目,0,0,0,0,0,0,0
13118004008,荒川区,東尾久８丁目,3346,194,1633,94,1713,100,1538
131180050,荒川区,西尾久,25090,737,12201,342,12889,395,11990
13118005001,荒川区,西尾久１丁目,2902,73,1435,35,1467,38,1448
13118005002,荒川区,西尾久２丁目,2688,99,1302,58,1386,41,1313
13118005003,荒川区,西尾久３丁目,2047,36,1004,11,1043,25,992
13118005004,荒川区,西尾久４丁目,4311,226,2064,99,2247,127,2187
13118005005,荒川区,西尾久５丁目,2218,47,1075,15,1143,32,1074
13118005006,荒川区,西尾久６丁目,2270,44,1104,29,1166,15,1023
13118005007,荒川区,西尾久７丁目,3612,116,1806,52,1806,64,1832
13118005008,荒川区,西尾久８丁目,5042,96,2411,43,2631,53,2121
131180060,荒川区,東日暮里,28903,3769,14408,1804,14495,1965,15332
13118006001,荒川区,東日暮里１丁目,3568,225,1777,93,1791,132,1963
13118006002,荒川区,東日暮里２丁目,3688,290,1872,136,1816,154,1866
13118006003,荒川区,東日暮里３丁目,5637,793,2770,365,2867,428,2881
13118006004,荒川区,東日暮里４丁目,3643,457,1849,206,1794,251,2009
13118006005,荒川区,東日暮里５丁目,5115,784,2485,382,2630,402,2867
13118006006,荒川区,東日暮里６丁目,7252,1220,3655,622,3597,598,3746
131180070,荒川区,西日暮里,23804,2952,11971,1524,11833,1428,12822
13118007001,荒川区,西日暮里１丁目,6599,1054,3344,565,3255,489,3458
13118007002,荒川区,西日暮里２丁目,6801,922,3361,467,3440,455,3513
13118007003,荒川区,西日暮里３丁目,1766,63,861,33,905,30,1049
13118007004,荒川区,西日暮里４丁目,1966,133,1018,79,948,54,1068
13118007005,荒川区,西日暮里５丁目,2233,277,1122,135,1111,142,1229
13118007006,荒川区,西日暮里６丁目,4439,503,2265,245,2174,258,2505
13119,板橋区,,561916,15295,276592,6760,285324,8535,291408
131190010,板橋区,板橋,23582,1092,11727,520,11855,572,14537
13119001001,板橋区,板橋１丁目,7292,455,3520,209,3772,246,4557
13119001002,板橋区,板橋２丁目,5892,166,2953,75,2939,91,3812
13119001003,板橋区,板橋３丁目,5568,220,2797,103,2771,117,3186
13119001004,板橋区,板橋４丁目,4830,251,2457,133,2373,118,2982
131190020,板橋区,加賀,9546,221,4235,69,5311,152,3962
13119002001,板橋区,加賀１丁目,4523,114,2054,48,2469,66,1551
13119002002,板橋区,加賀２丁目,5023,107,2181,21,2842,86,2411
131190030,板橋区,大山東町,5813,220,2889,90,2924,130,3565
131190040,板橋区,大山金井町,5442,253,2765,100,2677,153,3258
131190050,板橋区,熊野町,4128,251,2115,120,2013,131,2294
131190060,板橋区,中丸町,6147,317,3094,146,3053,171,3363
131190070,板橋区,南町,4625,193,2330,91,2295,102,2670
131190080,板橋区,稲荷台,2954,59,1469,29,1485,30,1467
131190090,板橋区,仲宿,7673,202,3841,86,3832,116,4184
131190100,板橋区,氷川町,4422,94,2190,51,2232,43,2535
131190110,板橋区,栄町,4084,112,2041,56,2043,56,2275
131190120,板橋区,大山町,4766,211,2374,91,2392,120,2750
131190130,板橋区,大山西町,4238,124,2066,49,2172,75,2507
131190140,板橋区,幸町,5184,210,2563,94,2621,116,2764
131190150,板橋区,中板橋,3886,135,1930,54,1956,81,2333
131190160,板橋区,仲町,4537,203,2141,39,2396,164,2310
131190170,板橋区,弥生町,5463,202,2746,91,2717,111,3108
131190180,板橋区,本町,6434,196,3111,82,3323,114,3665
131190190,板橋区,大和町,4892,97,2414,42,2478,55,2849
131190200,板橋区,双葉町,5177,106,2527,47,2650,59,2948
131190210,板橋区,富士見町,4020,104,1955,43,2065,61,2279
131190220,板橋区,大谷口上町,4118,98,2002,46,2116,52,2136
131190230,板橋区,大谷口北町,5902,185,2897,97,3005,88,2926
131190240,板橋区,大谷口,5834,134,2991,70,2843,64,3116
13119024001,板橋区,大谷口１丁目,2129,47,1130,24,999,23,1155
13119024002,板橋区,大谷口２丁目,3705,87,1861,46,1844,41,1961
131190250,板橋区,向原,7740,140,3774,64,3966,76,4298
13119025001,板橋区,向原１丁目,2409,57,1179,27,1230,30,1240
13119025002,板橋区,向原２丁目,2692,36,1325,16,1367,20,1654
13119025003,板橋区,向原３丁目,2639,47,1270,21,1369,26,1404
131190260,板橋区,小茂根,16351,369,7931,202,8420,167,8457
13119026001,板橋区,小茂根１丁目,4810,124,2329,62,2481,62,2770
13119026002,板橋区,小茂根２丁目,4066,76,2017,38,2049,38,2099
13119026003,板橋区,小茂根３丁目,2764,39,1357,19,1407,20,1226
13119026004,板橋区,小茂根４丁目,3632,74,1669,42,1963,32,1841
13119026005,板橋区,小茂根５丁目,1079,56,559,41,520,15,521
131190270,板橋区,常盤台,12400,250,5982,101,6418,149,6668
13119027001,板橋区,常盤台１丁目,4499,82,2178,35,2321,47,2459
13119027002,板橋区,常盤台２丁目,2148,37,1063,16,1085,21,1063
13119027003,板橋区,常盤台３丁目,3145,76,1524,32,1621,44,1697
13119027004,板橋区,常盤台４丁目,2608,55,1217,18,1391,37,1449
131190280,板橋区,南常盤台,6931,267,3337,130,3594,137,4237
13119028001,板橋区,南常盤台１丁目,3581,142,1671,61,1910,81,2269
13119028002,板橋区,南常盤台２丁目,3350,125,1666,69,1684,56,1968
131190290,板橋区,東新町,9543,159,4669,75,4874,84,4861
13119029001,板橋区,東新町１丁目,4859,99,2374,45,2485,54,2720
13119029002,板橋区,東新町２丁目,4684,60,2295,30,2389,30,2141
131190300,板橋区,上板橋,9103,264,4395,112,4708,152,5215
13119030001,板橋区,上板橋１丁目,2122,50,1078,20,1044,30,1227
13119030002,板橋区,上板橋２丁目,4813,151,2291,66,2522,85,2700
13119030003,板橋区,上板橋３丁目,2168,63,1026,26,1142,37,1288
131190310,板橋区,清水町,6742,216,3479,83,3263,133,3669
131190320,板橋区,蓮沼町,5129,108,2583,54,2546,54,2938
131190330,板橋区,大原町,4421,101,2244,48,2177,53,2236
131190340,板橋区,泉町,3266,71,1703,32,1563,39,1772
131190350,板橋区,宮本町,5599,106,2870,52,2729,54,3058
131190360,板橋区,志村,12656,332,6164,161,6492,171,6596
13119036001,板橋区,志村１丁目,5219,181,2492,95,2727,86,2777
13119036002,板橋区,志村２丁目,4193,74,2049,30,2144,44,2005
13119036003,板橋区,志村３丁目,3244,77,1623,36,1621,41,1814
131190370,板橋区,坂下,19249,578,9174,245,10075,333,9109
13119037001,板橋区,坂下１丁目,5738,170,2764,71,2974,99,2985
13119037002,板橋区,坂下２丁目,5850,180,2778,76,3072,104,2671
13119037003,板橋区,坂下３丁目,7661,228,3632,98,4029,130,3453
131190380,板橋区,東坂下,3628,86,1748,37,1880,49,1659
13119038001,板橋区,東坂下１丁目,2265,31,1102,11,1163,20,999
13119038002,板橋区,東坂下２丁目,1363,55,646,26,717,29,660
131190390,板橋区,小豆沢,14576,433,7054,215,7522,218,7410
13119039001,板橋区,小豆沢１丁目,3724,135,1727,62,1997,73,2015
13119039002,板橋区,小豆沢２丁目,5325,154,2574,86,2751,68,2532
13119039003,板橋区,小豆沢３丁目,1686,42,830,24,856,18,939
13119039004,板橋区,小豆沢４丁目,3841,102,1923,43,1918,59,1924
131190400,板橋区,西台,12851,201,6298,74,6553,127,5662
13119040001,板橋区,西台１丁目,2744,59,1362,26,1382,33,1319
13119040002,板橋区,西台２丁目,3952,46,1995,15,1957,31,1798
13119040003,板橋区,西台３丁目,3912,56,1913,20,1999,36,1625
13119040004,板橋区,西台４丁目,2243,40,1028,13,1215,27,920
131190410,板橋区,中台,15943,300,8065,121,7878,179,7761
13119041001,板橋区,中台１丁目,5488,112,2829,44,2659,68,2894
13119041002,板橋区,中台２丁目,3497,108,1914,37,1583,71,1798
13119041003,板橋区,中台３丁目,6958,80,3322,40,3636,40,3069
131190420,板橋区,若木,10353,282,5068,127,5285,155,4980
13119042001,板橋区,若木１丁目,4321,56,2047,23,2274,33,1898
13119042002,板橋区,若木２丁目,3712,165,1899,78,1813,87,2050
13119042003,板橋区,若木３丁目,2320,61,1122,26,1198,35,1032
131190430,板橋区,蓮根,17419,428,8490,178,8929,250,8442
13119043001,板橋区,蓮根１丁目,2917,92,1462,37,1455,55,1483
13119043002,板橋区,蓮根２丁目,7439,179,3704,83,3735,96,3684
13119043003,板橋区,蓮根３丁目,7063,157,3324,58,3739,99,3275
131190440,板橋区,相生町,4420,112,2119,53,2301,59,1932
131190450,板橋区,前野町,30748,788,14879,353,15869,435,14177
13119045001,板橋区,前野町１丁目,4814,84,2191,36,2623,48,2281
13119045002,板橋区,前野町２丁目,7151,209,3481,91,3670,118,3316
13119045003,板橋区,前野町３丁目,6117,127,3046,52,3071,75,2646
13119045004,板橋区,前野町４丁目,3915,95,1930,40,1985,55,1934
13119045005,板橋区,前野町５丁目,3834,196,1906,99,1928,97,1641
13119045006,板橋区,前野町６丁目,4917,77,2325,35,2592,42,2359
131190460,板橋区,赤塚,30890,642,15652,293,15238,349,16365
13119046001,板橋区,赤塚１丁目,3858,68,1868,28,1990,40,2014
13119046002,板橋区,赤塚２丁目,5486,120,2690,40,2796,80,3091
13119046003,板橋区,赤塚３丁目,5054,184,2624,93,2430,91,3201
13119046004,板橋区,赤塚４丁目,4207,67,2225,31,1982,36,2151
13119046005,板橋区,赤塚５丁目,3524,95,1847,56,1677,39,1688
13119046006,板橋区,赤塚６丁目,4143,44,2097,20,2046,24,2091
13119046007,板橋区,赤塚７丁目,3579,54,1770,19,1809,35,1734
13119046008,板橋区,赤塚８丁目,1039,10,531,6,508,4,395
131190470,板橋区,赤塚新町,9583,246,4731,106,4852,140,5038
13119047001,板橋区,赤塚新町１丁目,1200,23,583,8,617,15,734
13119047002,板橋区,赤塚新町２丁目,2007,52,966,17,1041,35,1127
13119047003,板橋区,赤塚新町３丁目,6376,171,3182,81,3194,90,3177
131190480,板橋区,四葉,4529,46,2364,20,2165,26,1885
13119048001,板橋区,四葉１丁目,2328,34,1274,16,1054,18,1106
13119048002,板橋区,四葉２丁目,2201,12,1090,4,1111,8,779
131190490,板橋区,大門,1158,12,532,7,626,5,362
131190500,板橋区,三園,6740,132,3544,59,3196,73,3099
13119050001,板橋区,三園１丁目,5728,85,3004,33,2724,52,2618
13119050002,板橋区,三園２丁目,1012,47,540,26,472,21,481
131190510,板橋区,成増,28464,703,13871,297,14593,406,14946
13119051001,板橋区,成増１丁目,6801,138,3288,59,3513,79,3481
13119051002,板橋区,成増２丁目,4972,121,2379,52,2593,69,2796
13119051003,板橋区,成増３丁目,7629,198,3712,75,3917,123,4017
13119051004,板橋区,成増４丁目,5299,137,2683,63,2616,74,2740
13119051005,板橋区,成増５丁目,3763,109,1809,48,1954,61,1912
131190520,板橋区,徳丸,35169,651,17383,284,17786,367,16443
13119052001,板橋区,徳丸１丁目,6615,173,3269,77,3346,96,3559
13119052002,板橋区,徳丸２丁目,4096,120,1970,60,2126,60,2225
13119052003,板橋区,徳丸３丁目,7537,128,3625,51,3912,77,3521
13119052004,板橋区,徳丸４丁目,5376,96,2654,45,2722,51,2341
13119052005,板橋区,徳丸５丁目,2220,44,1118,20,1102,24,889
13119052006,板橋区,徳丸６丁目,5323,42,2725,14,2598,28,2281
13119052007,板橋区,徳丸７丁目,1823,12,913,6,910,6,765
13119052008,板橋区,徳丸８丁目,2179,36,1109,11,1070,25,862
131190530,板橋区,東山町,3814,95,1861,43,1953,52,2034
131190540,板橋区,桜川,4727,111,2261,48,2466,63,2379
13119054001,板橋区,桜川１丁目,8,X,3,X,5,X,5
13119054002,板橋区,桜川２丁目,2573,62,1205,29,1368,33,1230
13119054003,板橋区,桜川３丁目,2146,49,1053,19,1093,30,1144
131190550,板橋区,高島平,49646,1521,24551,652,25095,869,26802
13119055001,板橋区,高島平１丁目,8260,155,4224,62,4036,93,4521
13119055002,板橋区,高島平２丁目,13443,769,6399,350,7044,419,8152
13119055003,板橋区,高島平３丁目,5706,104,2660,32,3046,72,2770
13119055004,板橋区,高島平４丁目,1966,32,1049,19,917,13,947
13119055005,板橋区,高島平５丁目,3153,20,1664,11,1489,9,1550
13119055006,板橋区,高島平６丁目,17,0,17,0,0,0,17
13119055007,板橋区,高島平７丁目,5114,145,2603,54,2511,91,2709
13119055008,板橋区,高島平８丁目,3851,102,1997,42,1854,60,2065
13119055009,板橋区,高島平９丁目,8136,194,3938,82,4198,112,4071
131190560,板橋区,新河岸,6133,176,2945,72,3188,104,2811
13119056001,板橋区,新河岸１丁目,2542,58,1244,24,1298,34,1014
13119056002,板橋区,新河岸２丁目,2773,104,1264,43,1509,61,1454
13119056003,板橋区,新河岸３丁目,818,14,437,5,381,9,343
131190570,板橋区,舟渡,9128,350,4458,159,4670,191,4306
13119057001,板橋区,舟渡１丁目,3622,120,1676,46,1946,74,1710
13119057002,板橋区,舟渡２丁目,3796,144,1929,73,1867,71,1766
13119057003,板橋区,舟渡３丁目,1633,84,829,40,804,44,769
13119057004,板橋区,舟渡４丁目,77,2,24,0,53,2,61
13120,練馬区,,721722,12696,351609,5724,370113,6972,337987
131200010,練馬区,旭丘,7299,158,3666,76,3633,82,4486
13120001001,練馬区,旭丘１丁目,4809,109,2470,51,2339,58,3049
13120001002,練馬区,旭丘２丁目,2490,49,1196,25,1294,24,1437
131200020,練馬区,小竹町,9084,198,4407,105,4677,93,5127
13120002001,練馬区,小竹町１丁目,5148,76,2528,44,2620,32,2906
13120002002,練馬区,小竹町２丁目,3936,122,1879,61,2057,61,2221
131200030,練馬区,栄町,3919,109,1896,58,2023,51,2322
131200040,練馬区,羽沢,6580,150,3221,64,3359,86,3554
13120004001,練馬区,羽沢１丁目,1402,20,678,10,724,10,877
13120004002,練馬区,羽沢２丁目,3356,100,1619,42,1737,58,1765
13120004003,練馬区,羽沢３丁目,1822,30,924,12,898,18,912
131200050,練馬区,豊玉上,6672,148,3185,48,3487,100,4203
13120005001,練馬区,豊玉上１丁目,2355,53,1157,20,1198,33,1467
13120005002,練馬区,豊玉上２丁目,4317,95,2028,28,2289,67,2736
131200060,練馬区,豊玉中,10128,203,5063,88,5065,115,5281
13120006001,練馬区,豊玉中１丁目,2472,42,1255,18,1217,24,1261
13120006002,練馬区,豊玉中２丁目,3176,79,1631,30,1545,49,1743
13120006003,練馬区,豊玉中３丁目,2867,67,1407,32,1460,35,1555
13120006004,練馬区,豊玉中４丁目,1613,15,770,8,843,7,722
131200070,練馬区,豊玉南,8494,232,4260,116,4234,116,3962
13120007001,練馬区,豊玉南１丁目,2467,42,1201,13,1266,29,1138
13120007002,練馬区,豊玉南２丁目,2130,52,1113,31,1017,21,1080
13120007003,練馬区,豊玉南３丁目,3897,138,1946,72,1951,66,1744
131200080,練馬区,豊玉北,18946,619,9159,270,9787,349,11123
13120008001,練馬区,豊玉北１丁目,2546,53,1158,25,1388,28,1431
13120008002,練馬区,豊玉北２丁目,2343,56,1112,28,1231,28,1320
13120008003,練馬区,豊玉北３丁目,3106,130,1578,57,1528,73,1898
13120008004,練馬区,豊玉北４丁目,3843,151,1898,66,1945,85,2317
13120008005,練馬区,豊玉北５丁目,3773,113,1795,48,1978,65,2391
13120008006,練馬区,豊玉北６丁目,3335,116,1618,46,1717,70,1766
131200090,練馬区,中村,9957,139,4805,61,5152,78,4556
13120009001,練馬区,中村１丁目,2480,39,1219,18,1261,21,1184
13120009002,練馬区,中村２丁目,3158,33,1553,16,1605,17,1398
13120009003,練馬区,中村３丁目,4319,67,2033,27,2286,40,1974
131200100,練馬区,中村南,10627,312,5112,149,5515,163,4848
13120010001,練馬区,中村南１丁目,3993,119,2019,66,1974,53,1782
13120010002,練馬区,中村南２丁目,3619,141,1735,63,1884,78,1732
13120010003,練馬区,中村南３丁目,3015,52,1358,20,1657,32,1334
131200110,練馬区,中村北,11491,337,5503,157,5988,180,6353
13120011001,練馬区,中村北１丁目,3642,149,1761,64,1881,85,2009
13120011002,練馬区,中村北２丁目,3019,77,1526,39,1493,38,1583
13120011003,練馬区,中村北３丁目,2008,39,946,18,1062,21,1222
13120011004,練馬区,中村北４丁目,2822,72,1270,36,1552,36,1539
131200120,練馬区,桜台,24724,475,11985,229,12739,246,12902
13120012001,練馬区,桜台１丁目,4947,142,2380,64,2567,78,2977
13120012002,練馬区,桜台２丁目,4784,90,2297,42,2487,48,2424
13120012003,練馬区,桜台３丁目,4671,70,2274,39,2397,31,2331
13120012004,練馬区,桜台４丁目,3159,66,1485,37,1674,29,1789
13120012005,練馬区,桜台５丁目,3616,51,1830,19,1786,32,1754
13120012006,練馬区,桜台６丁目,3547,56,1719,28,1828,28,1627
131200130,練馬区,練馬,14673,298,7231,135,7442,163,8424
13120013001,練馬区,練馬１丁目,4126,86,2026,33,2100,53,2491
13120013002,練馬区,練馬２丁目,3119,54,1536,24,1583,30,1713
13120013003,練馬区,練馬３丁目,3510,94,1779,46,1731,48,2172
13120013004,練馬区,練馬４丁目,3918,64,1890,32,2028,32,2048
131200140,練馬区,向山,10813,160,5275,69,5538,91,5115
13120014001,練馬区,向山１丁目,1811,48,866,20,945,28,1018
13120014002,練馬区,向山２丁目,2480,19,1278,10,1202,9,1095
13120014003,練馬区,向山３丁目,2394,30,1124,14,1270,16,1112
13120014004,練馬区,向山４丁目,4128,63,2007,25,2121,38,1890
131200150,練馬区,貫井,19364,432,9500,185,9864,247,10095
13120015001,練馬区,貫井１丁目,4572,76,2144,31,2428,45,2347
13120015002,練馬区,貫井２丁目,3620,67,1798,28,1822,39,1993
13120015003,練馬区,貫井３丁目,4848,192,2351,89,2497,103,2534
13120015004,練馬区,貫井４丁目,4199,54,2106,20,2093,34,2016
13120015005,練馬区,貫井５丁目,2125,43,1101,17,1024,26,1205
131200160,練馬区,錦,6010,120,2965,49,3045,71,2754
13120016001,練馬区,錦１丁目,3612,63,1745,25,1867,38,1656
13120016002,練馬区,錦２丁目,2398,57,1220,24,1178,33,1098
131200170,練馬区,氷川台,13449,217,6513,103,6936,114,6562
13120017001,練馬区,氷川台１丁目,245,9,107,2,138,7,113
13120017002,練馬区,氷川台２丁目,2839,41,1425,16,1414,25,1302
13120017003,練馬区,氷川台３丁目,5070,73,2442,43,2628,30,2540
13120017004,練馬区,氷川台４丁目,5295,94,2539,42,2756,52,2607
131200180,練馬区,平和台,13753,265,6856,125,6897,140,6075
13120018001,練馬区,平和台１丁目,3736,41,1861,19,1875,22,1624
13120018002,練馬区,平和台２丁目,2991,62,1458,29,1533,33,1310
13120018003,練馬区,平和台３丁目,4347,125,2211,60,2136,65,1907
13120018004,練馬区,平和台４丁目,2679,37,1326,17,1353,20,1234
131200190,練馬区,早宮,18812,194,9140,85,9672,109,8482
13120019001,練馬区,早宮１丁目,5903,72,2877,33,3026,39,2802
13120019002,練馬区,早宮２丁目,4091,34,1992,12,2099,22,1862
13120019003,練馬区,早宮３丁目,4627,47,2218,19,2409,28,2075
13120019004,練馬区,早宮４丁目,4191,41,2053,21,2138,20,1743
131200200,練馬区,春日町,24671,291,11896,130,12775,161,11315
13120020001,練馬区,春日町１丁目,4137,39,2012,13,2125,26,1921
13120020002,練馬区,春日町２丁目,4475,38,2189,15,2286,23,2011
13120020003,練馬区,春日町３丁目,4006,56,1896,18,2110,38,1927
13120020004,練馬区,春日町４丁目,4350,49,2099,23,2251,26,1919
13120020005,練馬区,春日町５丁目,4431,66,2098,38,2333,28,2048
13120020006,練馬区,春日町６丁目,3272,43,1602,23,1670,20,1489
131200210,練馬区,高松,17068,187,8462,81,8606,106,6999
13120021001,練馬区,高松１丁目,2815,24,1379,9,1436,15,1268
13120021002,練馬区,高松２丁目,2519,26,1210,9,1309,17,967
13120021003,練馬区,高松３丁目,3198,38,1551,17,1647,21,1111
13120021004,練馬区,高松４丁目,3135,26,1588,13,1547,13,1279
13120021005,練馬区,高松５丁目,2592,33,1303,15,1289,18,1144
13120021006,練馬区,高松６丁目,2809,40,1431,18,1378,22,1230
131200220,練馬区,北町,25764,545,13131,235,12633,310,12769
13120022001,練馬区,北町１丁目,4460,176,2193,80,2267,96,2490
13120022002,練馬区,北町２丁目,6216,102,3104,42,3112,60,3030
13120022003,練馬区,北町３丁目,2737,50,1347,17,1390,33,1306
13120022004,練馬区,北町４丁目,974,0,910,0,64,0,25
13120022005,練馬区,北町５丁目,2253,60,1121,27,1132,33,1114
13120022006,練馬区,北町６丁目,2558,43,1182,17,1376,26,1404
13120022007,練馬区,北町７丁目,2852,54,1431,26,1421,28,1437
13120022008,練馬区,北町８丁目,3714,60,1843,26,1871,34,1963
131200230,練馬区,田柄,28873,371,14268,163,14605,208,12212
13120023001,練馬区,田柄１丁目,4878,41,2359,19,2519,22,2109
13120023002,練馬区,田柄２丁目,6868,119,3348,59,3520,60,3283
13120023003,練馬区,田柄３丁目,6097,45,3081,22,3016,23,2427
13120023004,練馬区,田柄４丁目,6992,89,3486,27,3506,62,2705
13120023005,練馬区,田柄５丁目,4038,77,1994,36,2044,41,1688
131200240,練馬区,光が丘,28215,1288,13203,597,15012,691,11996
13120024001,練馬区,光が丘１丁目,2755,150,1277,73,1478,77,1463
13120024002,練馬区,光が丘２丁目,5909,253,2691,101,3218,152,2499
13120024003,練馬区,光が丘３丁目,9133,439,4371,202,4762,237,3704
13120024004,練馬区,光が丘４丁目,10,0,10,0,0,0,10
13120024005,練馬区,光が丘５丁目,3408,126,1539,58,1869,68,1475
13120024006,練馬区,光が丘６丁目,1104,13,498,3,606,10,454
13120024007,練馬区,光が丘７丁目,5896,307,2817,160,3079,147,2391
131200250,練馬区,旭町,12740,367,6297,172,6443,195,6160
13120025001,練馬区,旭町１丁目,4122,63,2024,22,2098,41,1720
13120025002,練馬区,旭町２丁目,4437,175,2204,86,2233,89,2310
13120025003,練馬区,旭町３丁目,4181,129,2069,64,2112,65,2130
131200260,練馬区,土支田,13067,123,6467,45,6600,78,5133
13120026001,練馬区,土支田１丁目,3498,34,1700,15,1798,19,1375
13120026002,練馬区,土支田２丁目,2405,25,1186,9,1219,16,1023
13120026003,練馬区,土支田３丁目,3921,33,1924,11,1997,22,1452
13120026004,練馬区,土支田４丁目,3243,31,1657,10,1586,21,1283
131200270,練馬区,富士見台,15175,303,7403,135,7772,168,7057
13120027001,練馬区,富士見台１丁目,3144,35,1520,17,1624,18,1368
13120027002,練馬区,富士見台２丁目,4018,125,1995,69,2023,56,2059
13120027003,練馬区,富士見台３丁目,4055,83,1935,25,2120,58,1976
13120027004,練馬区,富士見台４丁目,3958,60,1953,24,2005,36,1654
131200280,練馬区,南田中,12129,213,5853,102,6276,111,5790
13120028001,練馬区,南田中１丁目,2320,30,1132,15,1188,15,1047
13120028002,練馬区,南田中２丁目,1590,19,803,9,787,10,712
13120028003,練馬区,南田中３丁目,2784,81,1299,36,1485,45,1392
13120028004,練馬区,南田中４丁目,3059,48,1532,29,1527,19,1361
13120028005,練馬区,南田中５丁目,2376,35,1087,13,1289,22,1278
131200290,練馬区,高野台,14644,334,6925,134,7719,200,6471
13120029001,練馬区,高野台１丁目,3643,120,1672,47,1971,73,1640
13120029002,練馬区,高野台２丁目,2979,69,1439,28,1540,41,1298
13120029003,練馬区,高野台３丁目,2955,76,1400,32,1555,44,1348
13120029004,練馬区,高野台４丁目,2286,29,1080,8,1206,21,1016
13120029005,練馬区,高野台５丁目,2781,40,1334,19,1447,21,1169
131200300,練馬区,谷原,12346,114,6085,51,6261,63,4881
13120030001,練馬区,谷原１丁目,1849,24,930,10,919,14,812
13120030002,練馬区,谷原２丁目,1705,20,846,10,859,10,724
13120030003,練馬区,谷原３丁目,1973,12,950,6,1023,6,731
13120030004,練馬区,谷原４丁目,1918,33,954,18,964,15,635
13120030005,練馬区,谷原５丁目,2678,13,1291,5,1387,8,1110
13120030006,練馬区,谷原６丁目,2223,12,1114,2,1109,10,869
131200310,練馬区,三原台,9139,106,4565,48,4574,58,3834
13120031001,練馬区,三原台１丁目,4037,56,2031,28,2006,28,1762
13120031002,練馬区,三原台２丁目,1978,10,1011,4,967,6,789
13120031003,練馬区,三原台３丁目,3124,40,1523,16,1601,24,1283
131200320,練馬区,石神井町,27090,506,12932,233,14158,273,13553
13120032001,練馬区,石神井町１丁目,3086,89,1390,37,1696,52,1668
13120032002,練馬区,石神井町２丁目,4498,81,2106,33,2392,48,2204
13120032003,練馬区,石神井町３丁目,3075,57,1459,32,1616,25,1714
13120032004,練馬区,石神井町４丁目,3307,44,1608,22,1699,22,1612
13120032005,練馬区,石神井町５丁目,1707,32,861,14,846,18,880
13120032006,練馬区,石神井町６丁目,2867,55,1370,29,1497,26,1444
13120032007,練馬区,石神井町７丁目,4046,60,1961,30,2085,30,1895
13120032008,練馬区,石神井町８丁目,4504,88,2177,36,2327,52,2136
131200330,練馬区,石神井台,30080,410,14559,189,15521,221,13096
13120033001,練馬区,石神井台１丁目,1610,18,777,7,833,11,686
13120033002,練馬区,石神井台２丁目,4456,52,2170,28,2286,24,1903
13120033003,練馬区,石神井台３丁目,5465,93,2678,39,2787,54,2437
13120033004,練馬区,石神井台４丁目,4262,77,1962,27,2300,50,2002
13120033005,練馬区,石神井台５丁目,3923,29,1930,13,1993,16,1624
13120033006,練馬区,石神井台６丁目,3083,27,1486,15,1597,12,1155
13120033007,練馬区,石神井台７丁目,3558,78,1745,47,1813,31,1764
13120033008,練馬区,石神井台８丁目,3723,36,1811,13,1912,23,1525
131200340,練馬区,上石神井,18435,453,8987,228,9448,225,9695
13120034001,練馬区,上石神井１丁目,5355,163,2600,77,2755,86,3158
13120034002,練馬区,上石神井２丁目,4210,122,2056,61,2154,61,2139
13120034003,練馬区,上石神井３丁目,4575,65,2235,33,2340,32,2158
13120034004,練馬区,上石神井４丁目,4295,103,2096,57,2199,46,2240
131200350,練馬区,上石神井南町,2082,25,1030,12,1052,13,958
131200360,練馬区,下石神井,17615,368,8669,166,8946,202,7855
13120036001,練馬区,下石神井１丁目,2769,96,1323,33,1446,63,1164
13120036002,練馬区,下石神井２丁目,3104,56,1534,28,1570,28,1352
13120036003,練馬区,下石神井３丁目,2364,61,1141,30,1223,31,966
13120036004,練馬区,下石神井４丁目,3466,73,1726,32,1740,41,1806
13120036005,練馬区,下石神井５丁目,2529,46,1265,25,1264,21,1151
13120036006,練馬区,下石神井６丁目,3383,36,1680,18,1703,18,1416
131200370,練馬区,立野町,4992,40,2436,21,2556,19,2204
131200380,練馬区,関町東,5297,91,2606,42,2691,49,2727
13120038001,練馬区,関町東１丁目,3878,71,1914,35,1964,36,1896
13120038002,練馬区,関町東２丁目,1419,20,692,7,727,13,831
131200390,練馬区,関町北,21570,358,10390,162,11180,196,10392
13120039001,練馬区,関町北１丁目,3380,57,1588,20,1792,37,1839
13120039002,練馬区,関町北２丁目,4253,64,2035,31,2218,33,2353
13120039003,練馬区,関町北３丁目,4212,92,2061,43,2151,49,2012
13120039004,練馬区,関町北４丁目,4147,83,1988,42,2159,41,1997
13120039005,練馬区,関町北５丁目,5578,62,2718,26,2860,36,2191
131200400,練馬区,関町南,16980,237,8161,108,8819,129,7846
13120040001,練馬区,関町南１丁目,2587,78,1188,17,1399,61,1329
13120040002,練馬区,関町南２丁目,4175,73,1992,42,2183,31,2012
13120040003,練馬区,関町南３丁目,3192,42,1625,22,1567,20,1543
13120040004,練馬区,関町南４丁目,7026,44,3356,27,3670,17,2962
131200410,練馬区,東大泉,34252,372,16263,152,17989,220,16371
13120041001,練馬区,東大泉１丁目,4661,63,2194,26,2467,37,2227
13120041002,練馬区,東大泉２丁目,6276,60,3007,21,3269,39,2721
13120041003,練馬区,東大泉３丁目,4609,44,2102,19,2507,25,2364
13120041004,練馬区,東大泉４丁目,2702,44,1325,17,1377,27,1541
13120041005,練馬区,東大泉５丁目,3740,34,1743,13,1997,21,1861
13120041006,練馬区,東大泉６丁目,6123,70,2894,30,3229,40,3016
13120041007,練馬区,東大泉７丁目,6141,57,2998,26,3143,31,2641
131200420,練馬区,西大泉町,11,0,5,0,6,0,6
131200430,練馬区,西大泉,21564,123,10567,48,10997,75,8637
13120043001,練馬区,西大泉１丁目,3984,25,1976,13,2008,12,1742
13120043002,練馬区,西大泉２丁目,3037,10,1466,4,1571,6,1175
13120043003,練馬区,西大泉３丁目,3602,25,1792,10,1810,15,1526
13120043004,練馬区,西大泉４丁目,3533,21,1716,4,1817,17,1303
13120043005,練馬区,西大泉５丁目,4795,26,2338,14,2457,12,1846
13120043006,練馬区,西大泉６丁目,2613,16,1279,3,1334,13,1045
131200440,練馬区,南大泉,26573,278,13070,122,13503,156,11223
13120044001,練馬区,南大泉１丁目,4681,54,2287,24,2394,30,1912
13120044002,練馬区,南大泉２丁目,4390,42,2147,20,2243,22,1731
13120044003,練馬区,南大泉３丁目,4760,46,2329,19,2431,27,2028
13120044004,練馬区,南大泉４丁目,6120,65,3075,28,3045,37,2745
13120044005,練馬区,南大泉５丁目,4735,58,2302,25,2433,33,2047
13120044006,練馬区,南大泉６丁目,1887,13,930,6,957,7,760
131200450,練馬区,大泉町,22271,180,11004,65,11267,115,8822
13120045001,練馬区,大泉町１丁目,5166,42,2555,12,2611,30,1972
13120045002,練馬区,大泉町２丁目,4837,32,2378,12,2459,20,1861
13120045003,練馬区,大泉町３丁目,3999,33,1986,12,2013,21,1577
13120045004,練馬区,大泉町４丁目,3694,39,1847,15,1847,24,1427
13120045005,練馬区,大泉町５丁目,2139,13,1069,4,1070,9,954
13120045006,練馬区,大泉町６丁目,2436,21,1169,10,1267,11,1031
131200460,練馬区,大泉学園町,34284,247,16633,111,17651,136,13761
13120046001,練馬区,大泉学園町１丁目,3001,24,1436,10,1565,14,1290
13120046002,練馬区,大泉学園町２丁目,3785,45,1825,20,1960,25,1640
13120046003,練馬区,大泉学園町３丁目,3167,22,1606,11,1561,11,1196
13120046004,練馬区,大泉学園町４丁目,4369,30,2127,14,2242,16,1663
13120046005,練馬区,大泉学園町５丁目,4741,21,2300,12,2441,9,1813
13120046006,練馬区,大泉学園町６丁目,5195,37,2544,15,2651,22,2063
13120046007,練馬区,大泉学園町７丁目,5021,31,2366,14,2655,17,2133
13120046008,練馬区,大泉学園町８丁目,4885,37,2358,15,2527,22,1955
13120046009,練馬区,大泉学園町９丁目,120,0,71,0,49,0,8
13121,足立区,,670122,21563,334922,9280,335200,12283,310662
131210010,足立区,青井,17595,507,8731,215,8864,292,8063
13121001001,足立区,青井１丁目,1544,49,805,24,739,25,719
13121001002,足立区,青井２丁目,3036,65,1580,32,1456,33,1533
13121001003,足立区,青井３丁目,4683,146,2233,55,2450,91,2168
13121001004,足立区,青井４丁目,4043,120,1943,46,2100,74,1731
13121001005,足立区,青井５丁目,2012,83,1026,41,986,42,974
13121001006,足立区,青井６丁目,2277,44,1144,17,1133,27,938
131210020,足立区,足立,12917,351,6552,165,6365,186,6667
13121002001,足立区,足立１丁目,2625,89,1335,44,1290,45,1365
13121002002,足立区,足立２丁目,3055,85,1576,46,1479,39,1614
13121002003,足立区,足立３丁目,3700,103,1865,42,1835,61,1815
13121002004,足立区,足立４丁目,3537,74,1776,33,1761,41,1873
131210030,足立区,綾瀬,24558,911,12444,419,12114,492,12974
13121003001,足立区,綾瀬１丁目,4805,124,2374,56,2431,68,2382
13121003002,足立区,綾瀬２丁目,4745,179,2333,73,2412,106,2581
13121003003,足立区,綾瀬３丁目,3312,157,1633,66,1679,91,1823
13121003004,足立区,綾瀬４丁目,3103,100,1669,52,1434,48,1827
13121003005,足立区,綾瀬５丁目,3215,131,1733,68,1482,63,1770
13121003006,足立区,綾瀬６丁目,3144,143,1612,72,1532,71,1562
13121003007,足立区,綾瀬７丁目,2234,77,1090,32,1144,45,1029
131210050,足立区,伊興,12289,329,6084,133,6205,196,5427
13121005001,足立区,伊興１丁目,2284,43,1122,18,1162,25,1069
13121005002,足立区,伊興２丁目,2198,41,1114,14,1084,27,864
13121005003,足立区,伊興３丁目,2972,126,1429,53,1543,73,1337
13121005004,足立区,伊興４丁目,2842,66,1424,30,1418,36,1297
13121005005,足立区,伊興５丁目,1993,53,995,18,998,35,860
131210090,足立区,入谷町，舎人町,0,0,0,0,0,0,0
131210100,足立区,入谷,8528,224,4315,95,4213,129,3402
13121010001,足立区,入谷１丁目,1922,45,940,15,982,30,751
13121010002,足立区,入谷２丁目,1246,26,630,11,616,15,488
13121010003,足立区,入谷３丁目,1204,47,602,20,602,27,464
13121010004,足立区,入谷４丁目,941,51,475,23,466,28,369
13121010005,足立区,入谷５丁目,514,9,258,7,256,2,196
13121010006,足立区,入谷６丁目,53,0,53,0,0,0,53
13121010007,足立区,入谷７丁目,628,11,365,5,263,6,280
13121010008,足立区,入谷８丁目,1078,14,514,5,564,9,439
13121010009,足立区,入谷９丁目,942,21,478,9,464,12,362
131210110,足立区,梅田,24367,789,12138,333,12229,456,11147
13121011001,足立区,梅田１丁目,1892,77,953,39,939,38,898
13121011002,足立区,梅田２丁目,2294,71,1186,34,1108,37,1147
13121011003,足立区,梅田３丁目,2308,78,1204,30,1104,48,1107
13121011004,足立区,梅田４丁目,2216,86,1122,38,1094,48,1003
13121011005,足立区,梅田５丁目,3754,136,1886,62,1868,74,1701
13121011006,足立区,梅田６丁目,3431,83,1688,31,1743,52,1555
13121011007,足立区,梅田７丁目,4823,103,2330,44,2493,59,2202
13121011008,足立区,梅田８丁目,3649,155,1769,55,1880,100,1534
131210120,足立区,梅島,11350,413,5641,153,5709,260,5757
13121012001,足立区,梅島１丁目,3359,111,1722,50,1637,61,1770
13121012002,足立区,梅島２丁目,3313,107,1633,45,1680,62,1568
13121012003,足立区,梅島３丁目,4678,195,2286,58,2392,137,2419
131210130,足立区,扇,14878,630,7261,288,7617,342,6665
13121013001,足立区,扇１丁目,6730,272,3247,121,3483,151,2892
13121013002,足立区,扇２丁目,4769,225,2378,103,2391,122,2204
13121013003,足立区,扇３丁目,3379,133,1636,64,1743,69,1569
131210140,足立区,大谷田,16466,656,8471,286,7995,370,7711
13121014001,足立区,大谷田１丁目,4610,326,2358,157,2252,169,2285
13121014002,足立区,大谷田２丁目,2371,55,1167,19,1204,36,986
13121014003,足立区,大谷田３丁目,4006,117,2038,51,1968,66,1859
13121014004,足立区,大谷田４丁目,1716,42,892,12,824,30,869
13121014005,足立区,大谷田５丁目,3763,116,2016,47,1747,69,1712
131210150,足立区,興野,6110,273,3099,123,3011,150,2565
13121015001,足立区,興野１丁目,1986,119,964,53,1022,66,835
13121015002,足立区,興野２丁目,4124,154,2135,70,1989,84,1730
131210160,足立区,小台,6580,272,3314,127,3266,145,2769
13121016001,足立区,小台１丁目,2746,197,1361,98,1385,99,1161
13121016002,足立区,小台２丁目,3834,75,1953,29,1881,46,1608
131210170,足立区,加賀,3981,114,1999,42,1982,72,1631
13121017001,足立区,加賀１丁目,1209,26,646,10,563,16,510
13121017002,足立区,加賀２丁目,2772,88,1353,32,1419,56,1121
131210180,足立区,加平,5903,206,3115,98,2788,108,3064
13121018001,足立区,加平１丁目,2663,104,1387,54,1276,50,1328
13121018002,足立区,加平２丁目,1154,28,627,12,527,16,690
13121018003,足立区,加平３丁目,2086,74,1101,32,985,42,1046
131210190,足立区,北加平町,2193,49,1176,20,1017,29,1031
131210200,足立区,栗原,12361,409,6185,184,6176,225,5881
13121020001,足立区,栗原１丁目,2570,94,1261,38,1309,56,1305
13121020002,足立区,栗原２丁目,3009,105,1533,50,1476,55,1565
13121020003,足立区,栗原３丁目,3614,101,1813,48,1801,53,1703
13121020004,足立区,栗原４丁目,3168,109,1578,48,1590,61,1308
131210210,足立区,江北,19027,530,9213,218,9814,312,9032
13121021001,足立区,江北１丁目,2650,78,1271,32,1379,46,1261
13121021002,足立区,江北２丁目,2596,64,1286,22,1310,42,1143
13121021003,足立区,江北３丁目,3932,92,1903,36,2029,56,1665
13121021004,足立区,江北４丁目,3887,102,1827,38,2060,64,1947
13121021005,足立区,江北５丁目,649,8,320,4,329,4,347
13121021006,足立区,江北６丁目,2859,109,1413,51,1446,58,1457
13121021007,足立区,江北７丁目,2454,77,1193,35,1261,42,1212
131210230,足立区,古千谷,0,0,0,0,0,0,0
13121023001,足立区,古千谷１丁目,0,0,0,0,0,0,0
13121023002,足立区,古千谷２丁目,0,0,0,0,0,0,0
131210240,足立区,弘道,6893,247,3481,108,3412,139,3741
13121024001,足立区,弘道１丁目,3484,143,1705,59,1779,84,1910
13121024002,足立区,弘道２丁目,3409,104,1776,49,1633,55,1831
131210250,足立区,佐野,5415,108,2828,50,2587,58,2329
13121025001,足立区,佐野１丁目,2158,49,1105,22,1053,27,827
13121025002,足立区,佐野２丁目,3257,59,1723,28,1534,31,1502
131210260,足立区,皿沼,3621,117,1868,48,1753,69,1551
13121026001,足立区,皿沼１丁目,1386,32,729,12,657,20,587
13121026002,足立区,皿沼２丁目,1181,54,597,23,584,31,523
13121026003,足立区,皿沼３丁目,1054,31,542,13,512,18,441
131210270,足立区,鹿浜,17677,561,8886,215,8791,346,7554
13121027001,足立区,鹿浜１丁目,1111,42,582,20,529,22,444
13121027002,足立区,鹿浜２丁目,3026,120,1537,41,1489,79,1294
13121027003,足立区,鹿浜３丁目,2001,42,1016,16,985,26,822
13121027004,足立区,鹿浜４丁目,2120,56,1090,25,1030,31,955
13121027005,足立区,鹿浜５丁目,2847,90,1366,39,1481,51,1269
13121027006,足立区,鹿浜６丁目,2464,68,1196,22,1268,46,1139
13121027007,足立区,鹿浜７丁目,2292,85,1158,30,1134,55,900
13121027008,足立区,鹿浜８丁目,1816,58,941,22,875,36,731
131210280,足立区,島根,12171,336,6001,139,6170,197,5595
13121028001,足立区,島根１丁目,1798,43,902,17,896,26,872
13121028002,足立区,島根２丁目,4698,133,2282,53,2416,80,1986
13121028003,足立区,島根３丁目,2443,83,1262,34,1181,49,1285
13121028004,足立区,島根４丁目,3232,77,1555,35,1677,42,1452
131210290,足立区,神明南,3469,61,1762,21,1707,40,1437
13121029001,足立区,神明南１丁目,2024,30,1025,12,999,18,825
13121029002,足立区,神明南２丁目,1445,31,737,9,708,22,612
131210300,足立区,神明,4847,68,2533,25,2314,43,1925
13121030001,足立区,神明１丁目,852,12,452,1,400,11,339
13121030002,足立区,神明２丁目,1804,37,914,16,890,21,723
13121030003,足立区,神明３丁目,2191,19,1167,8,1024,11,863
131210310,足立区,新田,16007,1219,8068,580,7939,639,6652
13121031001,足立区,新田１丁目,3615,151,1837,62,1778,89,1685
13121031002,足立区,新田２丁目,2615,98,1299,45,1316,53,1098
13121031003,足立区,新田３丁目,9777,970,4932,473,4845,497,3869
131210320,足立区,千住曙町,4441,176,2222,91,2219,85,1980
131210330,足立区,千住旭町,3490,53,1710,23,1780,30,1981
131210340,足立区,千住東,5833,171,2894,74,2939,97,2890
13121034001,足立区,千住東１丁目,1826,48,918,19,908,29,947
13121034002,足立区,千住東２丁目,4007,123,1976,55,2031,68,1943
131210350,足立区,千住大川町,3582,72,1849,36,1733,36,1777
131210360,足立区,千住河原町,3387,64,1701,24,1686,40,1766
131210370,足立区,関原,11123,600,5615,272,5508,328,5109
13121037001,足立区,関原１丁目,1997,223,1035,118,962,105,851
13121037002,足立区,関原２丁目,4321,202,2207,86,2114,116,1988
13121037003,足立区,関原３丁目,4805,175,2373,68,2432,107,2270
131210380,足立区,千住寿町,3125,64,1538,30,1587,34,1657
131210390,足立区,千住桜木,4624,97,2238,39,2386,58,2167
13121039001,足立区,千住桜木１丁目,2110,49,1050,21,1060,28,933
13121039002,足立区,千住桜木２丁目,2514,48,1188,18,1326,30,1234
131210400,足立区,千住関屋町,3951,115,1935,53,2016,62,1629
131210410,足立区,千住龍田町,1860,57,953,26,907,31,965
131210420,足立区,千住橋戸町,3500,188,1757,74,1743,114,1563
131210430,足立区,千住宮元町,1846,61,941,30,905,31,999
131210440,足立区,千住緑町,5309,175,2688,79,2621,96,2529
13121044001,足立区,千住緑町１丁目,1302,97,665,53,637,44,554
13121044002,足立区,千住緑町２丁目,2159,30,1069,7,1090,23,1046
13121044003,足立区,千住緑町３丁目,1848,48,954,19,894,29,929
131210450,足立区,千住元町,3747,131,1793,61,1954,70,1743
131210460,足立区,千住柳町,1690,31,855,15,835,16,818
131210470,足立区,千住中居町,2771,47,1388,17,1383,30,1440
131210480,足立区,千住仲町,3789,94,1914,34,1875,60,2125
131210490,足立区,千住,9405,159,4819,70,4586,89,5157
13121049001,足立区,千住１丁目,1585,32,823,14,762,18,932
13121049002,足立区,千住２丁目,1288,21,712,11,576,10,785
13121049003,足立区,千住３丁目,1875,25,933,12,942,13,931
13121049004,足立区,千住４丁目,2207,35,1082,12,1125,23,1207
13121049005,足立区,千住５丁目,2450,46,1269,21,1181,25,1302
131210500,足立区,竹の塚,18470,869,9033,382,9437,487,9587
13121050001,足立区,竹の塚１丁目,4103,231,1998,92,2105,139,2208
13121050002,足立区,竹の塚２丁目,2435,83,1263,35,1172,48,1172
13121050003,足立区,竹の塚３丁目,3312,165,1628,79,1684,86,1698
13121050004,足立区,竹の塚４丁目,1573,114,785,61,788,53,851
13121050005,足立区,竹の塚５丁目,2452,83,1205,38,1247,45,1240
13121050006,足立区,竹の塚６丁目,2428,103,1136,40,1292,63,1372
13121050007,足立区,竹の塚７丁目,2167,90,1018,37,1149,53,1046
131210510,足立区,辰沼,4001,122,1975,36,2026,86,1813
13121051001,足立区,辰沼１丁目,1978,85,913,24,1065,61,928
13121051002,足立区,辰沼２丁目,2023,37,1062,12,961,25,885
131210520,足立区,中央本町,14386,498,6929,200,7457,298,6447
13121052001,足立区,中央本町１丁目,2262,118,1093,54,1169,64,1009
13121052002,足立区,中央本町２丁目,3205,100,1543,44,1662,56,1576
13121052003,足立区,中央本町３丁目,2844,61,1383,22,1461,39,1232
13121052004,足立区,中央本町４丁目,4084,155,1965,58,2119,97,1747
13121052005,足立区,中央本町５丁目,1991,64,945,22,1046,42,883
131210530,足立区,椿,1638,43,831,15,807,28,696
13121053001,足立区,椿１丁目,183,1,100,0,83,1,83
13121053002,足立区,椿２丁目,1455,42,731,15,724,27,613
131210540,足立区,東和,19886,486,10026,211,9860,275,9275
13121054001,足立区,東和１丁目,3063,66,1603,27,1460,39,1522
13121054002,足立区,東和２丁目,3202,69,1658,28,1544,41,1702
13121054003,足立区,東和３丁目,5278,144,2656,63,2622,81,2235
13121054004,足立区,東和４丁目,4565,100,2189,39,2376,61,2025
13121054005,足立区,東和５丁目,3778,107,1920,54,1858,53,1791
131210560,足立区,舎人,14747,326,7385,134,7362,192,6296
13121056001,足立区,舎人１丁目,1672,45,845,12,827,33,762
13121056002,足立区,舎人２丁目,2566,56,1316,29,1250,27,1049
13121056003,足立区,舎人３丁目,2627,54,1349,27,1278,27,1094
13121056004,足立区,舎人４丁目,1310,26,679,10,631,16,528
13121056005,足立区,舎人５丁目,4074,66,2057,28,2017,38,1758
13121056006,足立区,舎人６丁目,2498,79,1139,28,1359,51,1105
131210570,足立区,中川,12502,236,6312,108,6190,128,5948
13121057001,足立区,中川１丁目,3154,37,1532,17,1622,20,1324
13121057002,足立区,中川２丁目,2440,63,1266,31,1174,32,1271
13121057003,足立区,中川３丁目,2057,41,1030,19,1027,22,1008
13121057004,足立区,中川４丁目,3931,85,1996,39,1935,46,1940
13121057005,足立区,中川５丁目,920,10,488,2,432,8,405
131210580,足立区,西綾瀬,8513,263,4252,133,4261,130,4209
13121058001,足立区,西綾瀬１丁目,1092,48,583,25,509,23,511
13121058002,足立区,西綾瀬２丁目,2782,71,1390,32,1392,39,1416
13121058003,足立区,西綾瀬３丁目,3397,111,1677,58,1720,53,1677
13121058004,足立区,西綾瀬４丁目,1242,33,602,18,640,15,605
131210590,足立区,西伊興町,0,0,0,0,0,0,0
131210600,足立区,西新井本町,14574,700,7031,285,7543,415,6798
13121060001,足立区,西新井本町１丁目,3195,198,1533,81,1662,117,1541
13121060002,足立区,西新井本町２丁目,3795,176,1810,78,1985,98,1697
13121060003,足立区,西新井本町３丁目,1618,89,769,36,849,53,773
13121060004,足立区,西新井本町４丁目,3602,164,1745,66,1857,98,1766
13121060005,足立区,西新井本町５丁目,2364,73,1174,24,1190,49,1021
131210610,足立区,西加平,368,9,199,4,169,5,174
13121061001,足立区,西加平１丁目,8,X,4,X,4,X,3
13121061002,足立区,西加平２丁目,360,X,195,X,165,X,171
131210620,足立区,西伊興,8481,190,4395,79,4086,111,3379
13121062001,足立区,西伊興１丁目,3063,105,1607,44,1456,61,1238
13121062002,足立区,西伊興２丁目,1835,40,948,19,887,21,734
13121062003,足立区,西伊興３丁目,1999,29,1037,12,962,17,794
13121062004,足立区,西伊興４丁目,1584,16,803,4,781,12,613
131210630,足立区,西新井栄町,9936,321,4864,125,5072,196,4697
13121063001,足立区,西新井栄町１丁目,6572,186,3232,69,3340,117,2911
13121063002,足立区,西新井栄町２丁目,1663,47,813,16,850,31,939
13121063003,足立区,西新井栄町３丁目,1701,88,819,40,882,48,847
131210640,足立区,西新井,20623,695,10268,282,10355,413,9274
13121064001,足立区,西新井１丁目,2796,140,1362,67,1434,73,1352
13121064002,足立区,西新井２丁目,2678,101,1339,40,1339,61,1291
13121064003,足立区,西新井３丁目,3402,172,1689,70,1713,102,1472
13121064004,足立区,西新井４丁目,3696,85,1880,31,1816,54,1544
13121064005,足立区,西新井５丁目,2777,46,1400,17,1377,29,1084
13121064006,足立区,西新井６丁目,3687,107,1811,42,1876,65,1795
13121064007,足立区,西新井７丁目,1587,44,787,15,800,29,736
131210650,足立区,西竹の塚,3004,121,1464,49,1540,72,1585
13121065001,足立区,西竹の塚１丁目,1848,88,881,34,967,54,916
13121065002,足立区,西竹の塚２丁目,1156,33,583,15,573,18,669
131210660,足立区,西保木間,10713,351,5213,147,5500,204,5093
13121066001,足立区,西保木間１丁目,2034,76,985,38,1049,38,979
13121066002,足立区,西保木間２丁目,3432,86,1692,30,1740,56,1523
13121066003,足立区,西保木間３丁目,2403,72,1161,23,1242,49,1139
13121066004,足立区,西保木間４丁目,2844,117,1375,56,1469,61,1452
131210670,足立区,花畑,18397,547,9168,223,9229,324,8278
13121067001,足立区,花畑１丁目,1917,30,971,13,946,17,839
13121067002,足立区,花畑２丁目,1775,61,880,21,895,40,710
13121067003,足立区,花畑３丁目,2458,27,1283,11,1175,16,1090
13121067004,足立区,花畑４丁目,2592,40,1237,12,1355,28,1132
13121067005,足立区,花畑５丁目,3286,71,1686,30,1600,41,1817
13121067006,足立区,花畑６丁目,2669,41,1347,19,1322,22,998
13121067007,足立区,花畑７丁目,1168,24,595,7,573,17,483
13121067008,足立区,花畑８丁目,2532,253,1169,110,1363,143,1209
131210680,足立区,東綾瀬,10067,507,5077,245,4990,262,4761
13121068001,足立区,東綾瀬１丁目,4083,200,2086,89,1997,111,2036
13121068002,足立区,東綾瀬２丁目,3341,170,1679,88,1662,82,1707
13121068003,足立区,東綾瀬３丁目,2643,137,1312,68,1331,69,1018
131210700,足立区,東伊興,6793,131,3486,62,3307,69,2949
13121070001,足立区,東伊興１丁目,1791,23,926,11,865,12,756
13121070002,足立区,東伊興２丁目,1818,26,940,11,878,15,797
13121070003,足立区,東伊興３丁目,2790,77,1418,38,1372,39,1215
13121070004,足立区,東伊興４丁目,394,5,202,2,192,3,181
131210710,足立区,一ツ家,7292,170,3748,63,3544,107,3198
13121071001,足立区,一ツ家１丁目,1630,33,841,11,789,22,687
13121071002,足立区,一ツ家２丁目,3149,95,1595,38,1554,57,1481
13121071003,足立区,一ツ家３丁目,1878,37,984,12,894,25,784
13121071004,足立区,一ツ家４丁目,635,5,328,2,307,3,246
131210720,足立区,日ノ出町,3908,155,1922,75,1986,80,2157
131210730,足立区,東保木間,6250,183,3039,81,3211,102,2813
13121073001,足立区,東保木間１丁目,4036,155,1928,70,2108,85,1930
13121073002,足立区,東保木間２丁目,2214,28,1111,11,1103,17,883
131210740,足立区,平野,4904,119,2429,46,2475,73,2050
13121074001,足立区,平野１丁目,1976,30,985,12,991,18,808
13121074002,足立区,平野２丁目,1029,16,532,7,497,9,395
13121074003,足立区,平野３丁目,1899,73,912,27,987,46,847
131210750,足立区,東六月町,1865,118,907,54,958,64,757
131210760,足立区,保木間,15664,358,7707,142,7957,216,6452
13121076001,足立区,保木間１丁目,4592,125,2255,45,2337,80,2048
13121076002,足立区,保木間２丁目,2389,48,1208,19,1181,29,976
13121076003,足立区,保木間３丁目,2406,76,1217,28,1189,48,1052
13121076004,足立区,保木間４丁目,2948,57,1403,25,1545,32,1032
13121076005,足立区,保木間５丁目,3329,52,1624,25,1705,27,1344
131210770,足立区,保塚町,3085,53,1602,18,1483,35,1307
131210780,足立区,堀之内,1305,37,651,19,654,18,591
13121078001,足立区,堀之内１丁目,557,18,278,8,279,10,246
13121078002,足立区,堀之内２丁目,748,19,373,11,375,8,345
131210790,足立区,南花畑,15707,316,7721,124,7986,192,7107
13121079001,足立区,南花畑１丁目,2199,35,1099,16,1100,19,954
13121079002,足立区,南花畑２丁目,4188,65,2166,24,2022,41,1834
13121079003,足立区,南花畑３丁目,2968,28,1518,12,1450,16,1295
13121079004,足立区,南花畑４丁目,3493,104,1598,46,1895,58,1620
13121079005,足立区,南花畑５丁目,2859,84,1340,26,1519,58,1404
131210800,足立区,宮城,4230,91,2088,33,2142,58,1986
13121080001,足立区,宮城１丁目,3785,85,1848,32,1937,53,1778
13121080002,足立区,宮城２丁目,445,6,240,1,205,5,208
131210810,足立区,六木,8888,251,4387,90,4501,161,3726
13121081001,足立区,六木１丁目,3379,121,1599,33,1780,88,1641
13121081002,足立区,六木２丁目,787,10,403,3,384,7,288
13121081003,足立区,六木３丁目,3069,86,1511,38,1558,48,1139
13121081004,足立区,六木４丁目,1653,34,874,16,779,18,658
131210820,足立区,本木北町,1452,48,706,20,746,28,563
131210830,足立区,本木,3918,186,1943,91,1975,95,1653
13121083001,足立区,本木１丁目,1737,83,871,43,866,40,726
13121083002,足立区,本木２丁目,2181,103,1072,48,1109,55,927
131210840,足立区,本木西町,989,43,506,18,483,25,425
131210850,足立区,本木東町,1539,62,791,37,748,25,728
131210860,足立区,本木南町,1667,42,891,20,776,22,779
131210870,足立区,谷中,10250,364,5379,161,4871,203,5069
13121087001,足立区,谷中１丁目,2980,105,1543,49,1437,56,1430
13121087002,足立区,谷中２丁目,1789,81,918,31,871,50,934
13121087003,足立区,谷中３丁目,2000,66,1073,31,927,35,913
13121087004,足立区,谷中４丁目,1653,50,886,26,767,24,902
13121087005,足立区,谷中５丁目,1828,62,959,24,869,38,890
131210880,足立区,谷在家,5903,183,2947,67,2956,116,2684
13121088001,足立区,谷在家１丁目,1763,47,900,17,863,30,757
13121088002,足立区,谷在家２丁目,1478,30,751,9,727,21,680
13121088003,足立区,谷在家３丁目,2662,106,1296,41,1366,65,1247
131210890,足立区,柳原,4929,100,2453,47,2476,53,2520
13121089001,足立区,柳原１丁目,2312,60,1120,27,1192,33,1139
13121089002,足立区,柳原２丁目,2617,40,1333,20,1284,20,1381
131210900,足立区,六月,7708,256,3681,120,4027,136,3332
13121090001,足立区,六月１丁目,3050,128,1442,67,1608,61,1301
13121090002,足立区,六月２丁目,2959,94,1369,38,1590,56,1175
13121090003,足立区,六月３丁目,1699,34,870,15,829,19,856
131210910,足立区,六町,5206,97,2693,39,2513,58,2675
13121091001,足立区,六町１丁目,1337,26,710,15,627,11,656
13121091002,足立区,六町２丁目,871,18,455,10,416,8,431
13121091003,足立区,六町３丁目,1764,40,892,9,872,31,879
13121091004,足立区,六町４丁目,1234,13,636,5,598,8,709
131210950,足立区,古千谷本町,7405,118,3712,38,3693,80,2883
13121095001,足立区,古千谷本町１丁目,1810,24,889,5,921,19,652
13121095002,足立区,古千谷本町２丁目,2591,42,1317,12,1274,30,1045
13121095003,足立区,古千谷本町３丁目,1685,27,838,7,847,20,665
13121095004,足立区,古千谷本町４丁目,1319,25,668,14,651,11,521
131210960,足立区,伊興本町,2283,63,1136,24,1147,39,1083
13121096001,足立区,伊興本町１丁目,1123,34,540,10,583,24,590
13121096002,足立区,伊興本町２丁目,1160,29,596,14,564,15,493
131210970,足立区,舎人公園,0,0,0,0,0,0,0
13122,葛飾区,,442913,13139,221621,6205,221292,6934,201380
131220010,葛飾区,立石,22203,477,11010,195,11193,282,10511
13122001001,葛飾区,立石１丁目,1893,41,933,18,960,23,957
13122001002,葛飾区,立石２丁目,2685,69,1400,27,1285,42,1257
13122001003,葛飾区,立石３丁目,2297,35,1158,13,1139,22,1038
13122001004,葛飾区,立石４丁目,2625,45,1276,22,1349,23,1230
13122001005,葛飾区,立石５丁目,2915,73,1448,30,1467,43,1339
13122001006,葛飾区,立石６丁目,3347,84,1629,41,1718,43,1504
13122001007,葛飾区,立石７丁目,1770,36,844,12,926,24,878
13122001008,葛飾区,立石８丁目,4671,94,2322,32,2349,62,2308
131220020,葛飾区,東立石,11146,219,5555,93,5591,126,5089
13122002001,葛飾区,東立石１丁目,2190,54,1116,24,1074,30,952
13122002002,葛飾区,東立石２丁目,2001,48,1005,17,996,31,950
13122002003,葛飾区,東立石３丁目,2281,40,1140,20,1141,20,1105
13122002004,葛飾区,東立石４丁目,4674,77,2294,32,2380,45,2082
131220030,葛飾区,四つ木,12505,222,6328,86,6177,136,5590
13122003001,葛飾区,四つ木１丁目,2655,42,1329,18,1326,24,1259
13122003002,葛飾区,四つ木２丁目,1961,46,958,21,1003,25,904
13122003003,葛飾区,四つ木３丁目,1883,40,988,18,895,22,846
13122003004,葛飾区,四つ木４丁目,3672,37,1859,11,1813,26,1533
13122003005,葛飾区,四つ木５丁目,2334,57,1194,18,1140,39,1048
131220040,葛飾区,東四つ木,13615,402,6814,192,6801,210,6016
13122004001,葛飾区,東四つ木１丁目,2122,46,1084,25,1038,21,956
13122004002,葛飾区,東四つ木２丁目,4193,188,2123,87,2070,101,1847
13122004003,葛飾区,東四つ木３丁目,3105,48,1520,21,1585,27,1388
13122004004,葛飾区,東四つ木４丁目,4195,120,2087,59,2108,61,1825
131220050,葛飾区,宝町,7295,165,3633,71,3662,94,3410
13122005001,葛飾区,宝町１丁目,3031,69,1526,22,1505,47,1332
13122005002,葛飾区,宝町２丁目,4264,96,2107,49,2157,47,2078
131220060,葛飾区,堀切,26861,658,13393,310,13468,348,12405
13122006001,葛飾区,堀切１丁目,4362,85,2152,37,2210,48,1920
13122006002,葛飾区,堀切２丁目,5580,141,2734,56,2846,85,2596
13122006003,葛飾区,堀切３丁目,2887,78,1456,38,1431,40,1348
13122006004,葛飾区,堀切４丁目,3438,136,1711,79,1727,57,1581
13122006005,葛飾区,堀切５丁目,2715,26,1377,14,1338,12,1373
13122006006,葛飾区,堀切６丁目,2462,46,1247,19,1215,27,1143
13122006007,葛飾区,堀切７丁目,2907,63,1457,31,1450,32,1249
13122006008,葛飾区,堀切８丁目,2510,83,1259,36,1251,47,1195
131220070,葛飾区,東堀切,7696,226,3696,106,4000,120,3305
13122007001,葛飾区,東堀切１丁目,2373,62,1145,25,1228,37,1083
13122007002,葛飾区,東堀切２丁目,3330,103,1597,49,1733,54,1390
13122007003,葛飾区,東堀切３丁目,1993,61,954,32,1039,29,832
131220080,葛飾区,小菅,13185,521,7699,276,5486,245,5828
13122008001,葛飾区,小菅１丁目,5863,197,3899,149,1964,48,2067
13122008002,葛飾区,小菅２丁目,2880,57,1520,22,1360,35,1332
13122008003,葛飾区,小菅３丁目,1851,84,923,25,928,59,892
13122008004,葛飾区,小菅４丁目,2591,183,1357,80,1234,103,1537
131220090,葛飾区,お花茶屋,6513,168,3283,75,3230,93,3080
13122009001,葛飾区,お花茶屋１丁目,1929,46,993,23,936,23,1076
13122009002,葛飾区,お花茶屋２丁目,1610,52,817,25,793,27,762
13122009003,葛飾区,お花茶屋３丁目,2974,70,1473,27,1501,43,1242
131220100,葛飾区,白鳥,12203,347,6023,161,6180,186,5325
13122010001,葛飾区,白鳥１丁目,1411,60,689,29,722,31,580
13122010002,葛飾区,白鳥２丁目,3365,106,1675,51,1690,55,1441
13122010003,葛飾区,白鳥３丁目,3343,93,1672,42,1671,51,1472
13122010004,葛飾区,白鳥４丁目,4084,88,1987,39,2097,49,1832
131220110,葛飾区,亀有,25442,663,12287,272,13155,391,12176
13122011001,葛飾区,亀有１丁目,4179,154,1991,80,2188,74,1877
13122011002,葛飾区,亀有２丁目,6061,125,2946,50,3115,75,2957
13122011003,葛飾区,亀有３丁目,6952,194,3374,71,3578,123,3246
13122011004,葛飾区,亀有４丁目,3548,44,1718,15,1830,29,1662
13122011005,葛飾区,亀有５丁目,4702,146,2258,56,2444,90,2434
131220120,葛飾区,西亀有,14015,403,6986,191,7029,212,6439
13122012001,葛飾区,西亀有１丁目,3061,111,1511,55,1550,56,1331
13122012002,葛飾区,西亀有２丁目,4781,175,2340,86,2441,89,2294
13122012003,葛飾区,西亀有３丁目,3860,81,1956,37,1904,44,1703
13122012004,葛飾区,西亀有４丁目,2313,36,1179,13,1134,23,1111
131220130,葛飾区,青戸,26394,685,13072,318,13322,367,12474
13122013001,葛飾区,青戸１丁目,1447,44,722,25,725,19,795
13122013002,葛飾区,青戸２丁目,1416,41,726,19,690,22,737
13122013003,葛飾区,青戸３丁目,5314,222,2561,105,2753,117,2712
13122013004,葛飾区,青戸４丁目,3436,88,1702,41,1734,47,1499
13122013005,葛飾区,青戸５丁目,2951,75,1454,30,1497,45,1444
13122013006,葛飾区,青戸６丁目,3262,55,1636,26,1626,29,1663
13122013007,葛飾区,青戸７丁目,5844,107,2886,46,2958,61,2346
13122013008,葛飾区,青戸８丁目,2724,53,1385,26,1339,27,1278
131220140,葛飾区,新小岩,15259,1657,7955,839,7304,818,8505
13122014001,葛飾区,新小岩１丁目,3606,455,1809,208,1797,247,2014
13122014002,葛飾区,新小岩２丁目,3904,597,2018,304,1886,293,2315
13122014003,葛飾区,新小岩３丁目,3905,280,2068,154,1837,126,2052
13122014004,葛飾区,新小岩４丁目,3844,325,2060,173,1784,152,2124
131220150,葛飾区,東新小岩,25134,1593,12885,790,12249,803,11674
13122015001,葛飾区,東新小岩１丁目,3639,186,1827,91,1812,95,1701
13122015002,葛飾区,東新小岩２丁目,3167,179,1626,87,1541,92,1283
13122015003,葛飾区,東新小岩３丁目,2989,577,1503,300,1486,277,1603
13122015004,葛飾区,東新小岩４丁目,2201,76,1150,40,1051,36,1013
13122015005,葛飾区,東新小岩５丁目,3261,234,1693,120,1568,114,1632
13122015006,葛飾区,東新小岩６丁目,3046,118,1589,62,1457,56,1404
13122015007,葛飾区,東新小岩７丁目,3225,136,1625,57,1600,79,1538
13122015008,葛飾区,東新小岩８丁目,3606,87,1872,33,1734,54,1500
131220160,葛飾区,西新小岩,16450,979,8157,531,8293,448,7647
13122016001,葛飾区,西新小岩１丁目,2695,110,1209,45,1486,65,1342
13122016002,葛飾区,西新小岩２丁目,963,364,532,220,431,144,429
13122016003,葛飾区,西新小岩３丁目,3773,76,1849,36,1924,40,1543
13122016004,葛飾区,西新小岩４丁目,5531,288,2777,158,2754,130,2724
13122016005,葛飾区,西新小岩５丁目,3488,141,1790,72,1698,69,1609
131220170,葛飾区,奥戸,20481,493,10396,194,10085,299,8725
13122017001,葛飾区,奥戸１丁目,2098,43,1069,15,1029,28,848
13122017002,葛飾区,奥戸２丁目,4877,78,2458,28,2419,50,2134
13122017003,葛飾区,奥戸３丁目,2973,68,1478,28,1495,40,1229
13122017004,葛飾区,奥戸４丁目,2231,81,1143,39,1088,42,923
13122017005,葛飾区,奥戸５丁目,1992,51,966,16,1026,35,917
13122017006,葛飾区,奥戸６丁目,1838,52,968,22,870,30,798
13122017007,葛飾区,奥戸７丁目,1709,34,871,15,838,19,665
13122017008,葛飾区,奥戸８丁目,1477,36,765,9,712,27,610
13122017009,葛飾区,奥戸９丁目,1286,50,678,22,608,28,601
131220180,葛飾区,高砂,19125,314,9556,151,9569,163,9369
13122018001,葛飾区,高砂１丁目,2388,58,1240,29,1148,29,1139
13122018002,葛飾区,高砂２丁目,2734,30,1383,13,1351,17,1381
13122018003,葛飾区,高砂３丁目,3734,86,1869,48,1865,38,1837
13122018004,葛飾区,高砂４丁目,1794,52,762,18,1032,34,952
13122018005,葛飾区,高砂５丁目,2446,26,1215,8,1231,18,1229
13122018006,葛飾区,高砂６丁目,1489,14,788,9,701,5,655
13122018007,葛飾区,高砂７丁目,2464,22,1292,15,1172,7,1180
13122018008,葛飾区,高砂８丁目,2076,26,1007,11,1069,15,996
131220190,葛飾区,鎌倉,12417,262,6143,118,6274,144,5548
13122019001,葛飾区,鎌倉１丁目,2747,104,1372,51,1375,53,1279
13122019002,葛飾区,鎌倉２丁目,2359,50,1154,22,1205,28,1046
13122019003,葛飾区,鎌倉３丁目,4548,55,2240,20,2308,35,1960
13122019004,葛飾区,鎌倉４丁目,2763,53,1377,25,1386,28,1263
131220200,葛飾区,細田,10753,268,5510,128,5243,140,4560
13122020001,葛飾区,細田１丁目,1969,41,985,21,984,20,801
13122020002,葛飾区,細田２丁目,349,4,172,1,177,3,124
13122020003,葛飾区,細田３丁目,2634,41,1341,17,1293,24,1054
13122020004,葛飾区,細田４丁目,3559,57,1790,25,1769,32,1450
13122020005,葛飾区,細田５丁目,2242,125,1222,64,1020,61,1131
131220210,葛飾区,柴又,22358,254,10999,109,11359,145,9822
13122021001,葛飾区,柴又１丁目,3894,55,1906,21,1988,34,1852
13122021002,葛飾区,柴又２丁目,2687,21,1336,7,1351,14,1090
13122021003,葛飾区,柴又３丁目,3835,51,1842,22,1993,29,1649
13122021004,葛飾区,柴又４丁目,4001,62,1963,28,2038,34,1780
13122021005,葛飾区,柴又５丁目,3256,22,1602,9,1654,13,1413
13122021006,葛飾区,柴又６丁目,3147,28,1580,12,1567,16,1351
13122021007,葛飾区,柴又７丁目,1538,15,770,10,768,5,687
131220220,葛飾区,新宿,12763,256,6239,118,6524,138,5563
13122022001,葛飾区,新宿１丁目,2382,29,1186,13,1196,16,1056
13122022002,葛飾区,新宿２丁目,1832,17,922,6,910,11,789
13122022003,葛飾区,新宿３丁目,1965,22,973,7,992,15,736
13122022004,葛飾区,新宿４丁目,2062,58,1005,28,1057,30,986
13122022005,葛飾区,新宿５丁目,1950,20,971,10,979,10,862
13122022006,葛飾区,新宿６丁目,2572,110,1182,54,1390,56,1134
131220230,葛飾区,金町,17147,368,8430,161,8717,207,8501
13122023001,葛飾区,金町１丁目,2485,46,1217,16,1268,30,1159
13122023002,葛飾区,金町２丁目,3258,67,1594,33,1664,34,1620
13122023003,葛飾区,金町３丁目,3793,102,1867,48,1926,54,1926
13122023004,葛飾区,金町４丁目,2421,59,1234,27,1187,32,1189
13122023005,葛飾区,金町５丁目,2668,63,1332,27,1336,36,1444
13122023006,葛飾区,金町６丁目,2522,31,1186,10,1336,21,1163
131220240,葛飾区,金町浄水場,0,0,0,0,0,0,0
131220250,葛飾区,東金町,23802,806,11672,384,12130,422,10933
13122025001,葛飾区,東金町１丁目,5615,436,2721,223,2894,213,2755
13122025002,葛飾区,東金町２丁目,3806,136,1785,61,2021,75,1748
13122025003,葛飾区,東金町３丁目,2602,58,1288,21,1314,37,1388
13122025004,葛飾区,東金町４丁目,2883,42,1410,19,1473,23,1310
13122025005,葛飾区,東金町５丁目,3758,79,1918,30,1840,49,1649
13122025006,葛飾区,東金町６丁目,2381,26,1166,15,1215,11,1087
13122025007,葛飾区,東金町７丁目,1924,10,964,5,960,5,698
13122025008,葛飾区,東金町８丁目,833,19,420,10,413,9,298
131220260,葛飾区,水元,13027,124,6468,53,6559,71,5019
13122026001,葛飾区,水元１丁目,2531,13,1281,5,1250,8,942
13122026002,葛飾区,水元２丁目,2879,51,1475,22,1404,29,1153
13122026003,葛飾区,水元３丁目,3206,30,1555,9,1651,21,1213
13122026004,葛飾区,水元４丁目,2986,13,1448,7,1538,6,1130
13122026005,葛飾区,水元５丁目,1425,17,709,10,716,7,581
131220270,葛飾区,水元公園,0,0,0,0,0,0,0
131220280,葛飾区,東水元,9101,117,4506,47,4595,70,3628
13122028001,葛飾区,東水元１丁目,1855,18,912,5,943,13,813
13122028002,葛飾区,東水元２丁目,2319,32,1163,14,1156,18,992
13122028003,葛飾区,東水元３丁目,1368,16,677,11,691,5,546
13122028004,葛飾区,東水元４丁目,1119,14,563,4,556,10,392
13122028005,葛飾区,東水元５丁目,2054,33,1004,12,1050,21,732
13122028006,葛飾区,東水元６丁目,386,4,187,1,199,3,153
131220290,葛飾区,南水元,13718,327,6758,161,6960,166,5659
13122029001,葛飾区,南水元１丁目,3817,100,1841,45,1976,55,1667
13122029002,葛飾区,南水元２丁目,2855,32,1469,16,1386,16,1151
13122029003,葛飾区,南水元３丁目,3734,157,1796,79,1938,78,1412
13122029004,葛飾区,南水元４丁目,3312,38,1652,21,1660,17,1429
131220300,葛飾区,西水元,12305,165,6168,75,6137,90,4579
13122030001,葛飾区,西水元１丁目,1909,37,974,19,935,18,763
13122030002,葛飾区,西水元２丁目,2629,25,1332,10,1297,15,958
13122030003,葛飾区,西水元３丁目,3060,34,1567,17,1493,17,1148
13122030004,葛飾区,西水元４丁目,1479,10,682,4,797,6,422
13122030005,葛飾区,西水元５丁目,1556,41,754,14,802,27,672
13122030006,葛飾区,西水元６丁目,1672,18,859,11,813,7,616
13123,江戸川区,,681298,23997,343464,10919,337834,13078,309072
131230011,江戸川区,小松川,14734,1407,7048,682,7686,725,5911
13123001101,江戸川区,小松川１丁目,5334,973,2615,491,2719,482,2281
13123001102,江戸川区,小松川２丁目,4887,227,2255,90,2632,137,1995
13123001103,江戸川区,小松川３丁目,4513,207,2178,101,2335,106,1635
131230012,江戸川区,小松川,1489,39,767,20,722,19,640
13123001203,江戸川区,小松川３丁目,273,10,153,6,120,4,125
13123001204,江戸川区,小松川４丁目,1216,29,614,14,602,15,515
131230020,江戸川区,平井,39938,2388,19821,1108,20117,1280,19843
13123002001,江戸川区,平井１丁目,3366,121,1711,61,1655,60,1690
13123002002,江戸川区,平井２丁目,4111,126,2074,60,2037,66,2006
13123002003,江戸川区,平井３丁目,5873,584,2709,257,3164,327,3271
13123002004,江戸川区,平井４丁目,6202,335,3113,155,3089,180,3020
13123002005,江戸川区,平井５丁目,4098,391,2031,195,2067,196,2317
13123002006,江戸川区,平井６丁目,6875,377,3530,175,3345,202,3691
13123002007,江戸川区,平井７丁目,9413,454,4653,205,4760,249,3848
131230030,江戸川区,中央,14241,394,7076,183,7165,211,6144
13123003001,江戸川区,中央１丁目,3898,69,1911,28,1987,41,1669
13123003002,江戸川区,中央２丁目,4447,93,2226,43,2221,50,1952
13123003003,江戸川区,中央３丁目,2651,49,1310,20,1341,29,1146
13123003004,江戸川区,中央４丁目,3245,183,1629,92,1616,91,1377
131230040,江戸川区,松島,17540,719,8990,316,8550,403,8300
13123004001,江戸川区,松島１丁目,3339,91,1714,36,1625,55,1453
13123004002,江戸川区,松島２丁目,4004,106,2029,49,1975,57,1713
13123004003,江戸川区,松島３丁目,5923,357,3016,165,2907,192,2913
13123004004,江戸川区,松島４丁目,4274,165,2231,66,2043,99,2221
131230050,江戸川区,松江,20600,382,10435,169,10165,213,8770
13123005001,江戸川区,松江１丁目,2218,29,1152,11,1066,18,965
13123005002,江戸川区,松江２丁目,4649,81,2358,33,2291,48,1926
13123005003,江戸川区,松江３丁目,2119,38,1033,11,1086,27,920
13123005004,江戸川区,松江４丁目,2993,57,1506,30,1487,27,1155
13123005005,江戸川区,松江５丁目,3537,89,1793,40,1744,49,1635
13123005006,江戸川区,松江６丁目,1156,28,621,17,535,11,542
13123005007,江戸川区,松江７丁目,3928,60,1972,27,1956,33,1627
131230060,江戸川区,東小松川,11415,224,5736,102,5679,122,4963
13123006001,江戸川区,東小松川１丁目,1716,32,831,13,885,19,698
13123006002,江戸川区,東小松川２丁目,3179,54,1557,23,1622,31,1278
13123006003,江戸川区,東小松川３丁目,2722,39,1352,14,1370,25,1196
13123006004,江戸川区,東小松川４丁目,3798,99,1996,52,1802,47,1791
131230070,江戸川区,西小松川町,3184,41,1657,17,1527,24,1358
131230080,江戸川区,大杉,10787,161,5387,65,5400,96,4050
13123008001,江戸川区,大杉１丁目,2327,43,1175,24,1152,19,885
13123008002,江戸川区,大杉２丁目,1942,32,938,11,1004,21,715
13123008003,江戸川区,大杉３丁目,1525,29,763,16,762,13,548
13123008004,江戸川区,大杉４丁目,2000,26,1030,5,970,21,739
13123008005,江戸川区,大杉５丁目,2993,31,1481,9,1512,22,1163
131230090,江戸川区,西一之江,9757,148,4946,58,4811,90,3825
13123009001,江戸川区,西一之江１丁目,1772,31,905,17,867,14,716
13123009002,江戸川区,西一之江２丁目,1880,33,956,11,924,22,710
13123009003,江戸川区,西一之江３丁目,4237,54,2224,20,2013,34,1733
13123009004,江戸川区,西一之江４丁目,1868,30,861,10,1007,20,666
131230100,江戸川区,一之江町,889,6,448,2,441,4,338
131230110,江戸川区,一之江,20005,331,10110,149,9895,182,8802
13123011001,江戸川区,一之江１丁目,1410,27,733,7,677,20,524
13123011002,江戸川区,一之江２丁目,1729,27,903,16,826,11,698
13123011003,江戸川区,一之江３丁目,2534,50,1334,24,1200,26,1388
13123011004,江戸川区,一之江４丁目,2139,28,1107,8,1032,20,1012
13123011005,江戸川区,一之江５丁目,2332,24,1177,12,1155,12,896
13123011006,江戸川区,一之江６丁目,3592,71,1775,32,1817,39,1356
13123011007,江戸川区,一之江７丁目,4915,58,2432,28,2483,30,2321
13123011008,江戸川区,一之江８丁目,1354,46,649,22,705,24,607
131230120,江戸川区,二之江町,711,5,359,3,352,2,289
131230130,江戸川区,春江町,16583,239,8384,108,8199,131,6810
13123013001,江戸川区,春江町１丁目,809,22,411,10,398,12,420
13123013002,江戸川区,春江町２丁目,4476,67,2299,24,2177,43,1833
13123013003,江戸川区,春江町３丁目,5055,55,2543,38,2512,17,2062
13123013004,江戸川区,春江町４丁目,1464,23,736,10,728,13,551
13123013005,江戸川区,春江町５丁目,4779,72,2395,26,2384,46,1944
131230140,江戸川区,瑞江,10483,183,5317,83,5166,100,4874
13123014001,江戸川区,瑞江１丁目,3451,77,1768,38,1683,39,1524
13123014002,江戸川区,瑞江２丁目,3567,81,1804,36,1763,45,1822
13123014003,江戸川区,瑞江３丁目,1678,12,852,3,826,9,722
13123014004,江戸川区,瑞江４丁目,1787,13,893,6,894,7,806
131230150,江戸川区,東瑞江,7734,102,3845,43,3889,59,3542
13123015001,江戸川区,東瑞江１丁目,2306,32,1157,15,1149,17,1139
13123015002,江戸川区,東瑞江２丁目,2979,41,1479,18,1500,23,1237
13123015003,江戸川区,東瑞江３丁目,2449,29,1209,10,1240,19,1166
131230160,江戸川区,西瑞江,15080,262,7638,106,7442,156,6776
13123016003,江戸川区,西瑞江３丁目,8037,105,4197,53,3840,52,3653
13123016004,江戸川区,西瑞江４丁目,3548,82,1665,31,1883,51,1672
13123016005,江戸川区,西瑞江５丁目,3495,75,1776,22,1719,53,1451
131230170,江戸川区,江戸川,24284,337,12048,152,12236,185,10034
13123017001,江戸川区,江戸川１丁目,5062,63,2485,27,2577,36,2031
13123017002,江戸川区,江戸川２丁目,6144,84,3045,45,3099,39,2508
13123017003,江戸川区,江戸川３丁目,3506,58,1783,17,1723,41,1593
13123017004,江戸川区,江戸川４丁目,1235,20,637,16,598,4,567
13123017005,江戸川区,江戸川５丁目,4176,54,2071,21,2105,33,1634
13123017006,江戸川区,江戸川６丁目,4161,58,2027,26,2134,32,1701
131230200,江戸川区,東小岩,18021,535,8971,231,9050,304,8238
13123020001,江戸川区,東小岩１丁目,3907,98,1965,44,1942,54,1631
13123020002,江戸川区,東小岩２丁目,1705,24,860,8,845,16,712
13123020003,江戸川区,東小岩３丁目,2586,71,1307,33,1279,38,1187
13123020004,江戸川区,東小岩４丁目,3119,81,1502,32,1617,49,1366
13123020005,江戸川区,東小岩５丁目,3528,131,1740,56,1788,75,1739
13123020006,江戸川区,東小岩６丁目,3176,130,1597,58,1579,72,1603
131230210,江戸川区,西小岩,19527,1447,9692,572,9835,875,10072
13123021001,江戸川区,西小岩１丁目,5318,554,2596,210,2722,344,2814
13123021002,江戸川区,西小岩２丁目,2339,148,1215,65,1124,83,1257
13123021003,江戸川区,西小岩３丁目,4982,290,2402,117,2580,173,2482
13123021004,江戸川区,西小岩４丁目,3187,192,1610,84,1577,108,1593
13123021005,江戸川区,西小岩５丁目,3701,263,1869,96,1832,167,1926
131230220,江戸川区,南小岩,28693,1182,14266,467,14427,715,14056
13123022001,江戸川区,南小岩１丁目,2140,38,1075,12,1065,26,845
13123022002,江戸川区,南小岩２丁目,3622,90,1738,39,1884,51,1562
13123022003,江戸川区,南小岩３丁目,3230,93,1617,33,1613,60,1551
13123022004,江戸川区,南小岩４丁目,3180,113,1602,53,1578,60,1414
13123022005,江戸川区,南小岩５丁目,3824,157,1941,65,1883,92,1813
13123022006,江戸川区,南小岩６丁目,4021,156,2003,60,2018,96,2198
13123022007,江戸川区,南小岩７丁目,5350,281,2668,112,2682,169,2833
13123022008,江戸川区,南小岩８丁目,3326,254,1622,93,1704,161,1840
131230230,江戸川区,北小岩,27865,909,13942,390,13923,519,12828
13123023001,江戸川区,北小岩１丁目,1984,136,966,60,1018,76,1014
13123023002,江戸川区,北小岩２丁目,5586,267,2761,114,2825,153,2643
13123023003,江戸川区,北小岩３丁目,2289,72,1140,33,1149,39,1054
13123023004,江戸川区,北小岩４丁目,4093,91,2092,38,2001,53,1869
13123023005,江戸川区,北小岩５丁目,3177,95,1558,43,1619,52,1523
13123023006,江戸川区,北小岩６丁目,4261,160,2165,77,2096,83,2071
13123023007,江戸川区,北小岩７丁目,2960,46,1493,12,1467,34,1221
13123023008,江戸川区,北小岩８丁目,3515,42,1767,13,1748,29,1433
131230240,江戸川区,鹿骨町,145,11,70,4,75,7,59
131230250,江戸川区,鹿骨,14705,198,7464,72,7241,126,6042
13123025001,江戸川区,鹿骨１丁目,3528,52,1816,20,1712,32,1510
13123025002,江戸川区,鹿骨２丁目,3296,41,1725,16,1571,25,1379
13123025003,江戸川区,鹿骨３丁目,1788,29,847,8,941,21,628
13123025004,江戸川区,鹿骨４丁目,2581,18,1319,5,1262,13,1029
13123025005,江戸川区,鹿骨５丁目,2855,54,1444,22,1411,32,1222
13123025006,江戸川区,鹿骨６丁目,657,4,313,1,344,3,274
131230270,江戸川区,松本,4263,72,2131,33,2132,39,1741
13123027001,江戸川区,松本１丁目,2305,44,1159,19,1146,25,991
13123027002,江戸川区,松本２丁目,1958,28,972,14,986,14,750
131230280,江戸川区,興宮町,3138,49,1578,19,1560,30,1347
131230290,江戸川区,上一色,4494,115,2335,46,2159,69,2101
13123029001,江戸川区,上一色１丁目,1411,34,723,12,688,22,632
13123029002,江戸川区,上一色２丁目,1662,22,886,8,776,14,796
13123029003,江戸川区,上一色３丁目,1421,59,726,26,695,33,673
131230300,江戸川区,本一色,10601,302,5355,137,5246,165,4609
13123030001,江戸川区,本一色１丁目,4511,135,2282,64,2229,71,2042
13123030002,江戸川区,本一色２丁目,2377,54,1138,17,1239,37,933
13123030003,江戸川区,本一色３丁目,3713,113,1935,56,1778,57,1634
131230310,江戸川区,篠崎町,25065,378,12602,150,12463,228,10919
13123031001,江戸川区,篠崎町１丁目,3255,52,1621,23,1634,29,1506
13123031002,江戸川区,篠崎町２丁目,4103,60,2016,26,2087,34,1850
13123031003,江戸川区,篠崎町３丁目,3585,57,1779,26,1806,31,1337
13123031004,江戸川区,篠崎町４丁目,4772,81,2426,34,2346,47,2002
13123031005,江戸川区,篠崎町５丁目,1825,26,915,10,910,16,768
13123031006,江戸川区,篠崎町６丁目,2498,20,1273,6,1225,14,1072
13123031007,江戸川区,篠崎町７丁目,4358,70,2233,22,2125,48,2045
13123031008,江戸川区,篠崎町８丁目,669,12,339,3,330,9,339
131230320,江戸川区,東篠崎,2944,61,1311,27,1633,34,1194
13123032001,江戸川区,東篠崎１丁目,2338,55,996,24,1342,31,995
13123032002,江戸川区,東篠崎２丁目,606,6,315,3,291,3,199
131230330,江戸川区,東篠崎町,0,0,0,0,0,0,0
131230342,江戸川区,南篠崎町,19117,356,9481,156,9636,200,7769
13123034201,江戸川区,南篠崎町１丁目,4461,61,2234,30,2227,31,1639
13123034202,江戸川区,南篠崎町２丁目,3914,55,1952,16,1962,39,1625
13123034203,江戸川区,南篠崎町３丁目,2146,43,1030,18,1116,25,1115
13123034204,江戸川区,南篠崎町４丁目,4334,83,2248,43,2086,40,1724
13123034205,江戸川区,南篠崎町５丁目,4262,114,2017,49,2245,65,1666
131230360,江戸川区,北篠崎,4398,34,2199,7,2199,27,1616
13123036001,江戸川区,北篠崎１丁目,1043,4,535,0,508,4,377
13123036002,江戸川区,北篠崎２丁目,3355,30,1664,7,1691,23,1239
131230380,江戸川区,上篠崎,9507,119,4961,65,4546,54,4252
13123038001,江戸川区,上篠崎１丁目,1521,14,844,5,677,9,729
13123038002,江戸川区,上篠崎２丁目,2653,48,1344,28,1309,20,1145
13123038003,江戸川区,上篠崎３丁目,2157,24,1135,16,1022,8,993
13123038004,江戸川区,上篠崎４丁目,3176,33,1638,16,1538,17,1385
131230390,江戸川区,下篠崎町,2665,57,1371,28,1294,29,1188
131230400,江戸川区,船堀,25740,1203,12488,530,13252,673,11571
13123040001,江戸川区,船堀１丁目,4467,434,2036,197,2431,237,2103
13123040002,江戸川区,船堀２丁目,3862,85,1936,35,1926,50,1822
13123040003,江戸川区,船堀３丁目,5495,291,2626,129,2869,162,2466
13123040004,江戸川区,船堀４丁目,3456,73,1659,32,1797,41,1509
13123040005,江戸川区,船堀５丁目,2905,65,1501,31,1404,34,1282
13123040006,江戸川区,船堀６丁目,2564,187,1259,81,1305,106,1109
13123040007,江戸川区,船堀７丁目,2991,68,1471,25,1520,43,1280
131230410,江戸川区,宇喜田町,4354,45,2210,21,2144,24,1798
131230420,江戸川区,新堀,4511,63,2394,30,2117,33,1778
13123042001,江戸川区,新堀１丁目,2576,48,1367,22,1209,26,916
13123042002,江戸川区,新堀２丁目,1935,15,1027,8,908,7,862
131230430,江戸川区,東葛西,43679,1317,23019,602,20660,715,22539
13123043001,江戸川区,東葛西１丁目,5205,123,2682,59,2523,64,2397
13123043002,江戸川区,東葛西２丁目,3591,132,1977,55,1614,77,2199
13123043003,江戸川区,東葛西３丁目,1149,12,623,7,526,5,554
13123043004,江戸川区,東葛西４丁目,5947,174,3255,90,2692,84,2922
13123043005,江戸川区,東葛西５丁目,8206,357,4297,154,3909,203,4820
13123043006,江戸川区,東葛西６丁目,7642,288,4056,134,3586,154,4341
13123043007,江戸川区,東葛西７丁目,3493,96,1744,41,1749,55,1659
13123043008,江戸川区,東葛西８丁目,5480,89,2884,41,2596,48,2562
13123043009,江戸川区,東葛西９丁目,2966,46,1501,21,1465,25,1085
131230440,江戸川区,西葛西,43848,2863,21810,1372,22038,1491,21256
13123044001,江戸川区,西葛西１丁目,2668,114,1359,49,1309,65,1297
13123044002,江戸川区,西葛西２丁目,7996,343,3897,160,4099,183,3237
13123044003,江戸川区,西葛西３丁目,9316,536,4560,257,4756,279,4349
13123044004,江戸川区,西葛西４丁目,3620,97,1688,42,1932,55,1578
13123044005,江戸川区,西葛西５丁目,5098,692,2477,352,2621,340,2599
13123044006,江戸川区,西葛西６丁目,5998,418,3056,170,2942,248,3536
13123044007,江戸川区,西葛西７丁目,4687,291,2488,151,2199,140,2613
13123044008,江戸川区,西葛西８丁目,4465,372,2285,191,2180,181,2047
131230450,江戸川区,南葛西,34058,978,17571,482,16487,496,14676
13123045001,江戸川区,南葛西１丁目,2588,49,1332,27,1256,22,1119
13123045002,江戸川区,南葛西２丁目,5195,232,2896,132,2299,100,2724
13123045003,江戸川区,南葛西３丁目,6655,252,3421,119,3234,133,2817
13123045004,江戸川区,南葛西４丁目,3796,106,1977,39,1819,67,1695
13123045005,江戸川区,南葛西５丁目,6286,177,3185,93,3101,84,2465
13123045006,江戸川区,南葛西６丁目,5876,125,3026,57,2850,68,2377
13123045007,江戸川区,南葛西７丁目,3662,37,1734,15,1928,22,1479
131230460,江戸川区,北葛西,19821,516,10137,265,9684,251,8439
13123046001,江戸川区,北葛西１丁目,3162,59,1640,28,1522,31,1475
13123046002,江戸川区,北葛西２丁目,5931,148,3132,78,2799,70,2650
13123046003,江戸川区,北葛西３丁目,1000,18,517,10,483,8,423
13123046004,江戸川区,北葛西４丁目,6457,135,3172,72,3285,63,2518
13123046005,江戸川区,北葛西５丁目,3271,156,1676,77,1595,79,1373
131230470,江戸川区,中葛西,39011,1870,20392,887,18619,983,20991
13123047001,江戸川区,中葛西１丁目,6452,222,3278,102,3174,120,3125
13123047002,江戸川区,中葛西２丁目,3747,126,2031,66,1716,60,2002
13123047003,江戸川区,中葛西３丁目,5551,412,2935,181,2616,231,3605
13123047004,江戸川区,中葛西４丁目,3404,155,1749,56,1655,99,1857
13123047005,江戸川区,中葛西５丁目,7521,366,3742,182,3779,184,3862
13123047006,江戸川区,中葛西６丁目,3410,180,1861,100,1549,80,1706
13123047007,江戸川区,中葛西７丁目,5462,238,2928,122,2534,116,2815
13123047008,江戸川区,中葛西８丁目,3464,171,1868,78,1596,93,2019
131230480,江戸川区,堀江町,0,0,0,0,0,0,0
131230490,江戸川区,清新町,14110,1621,6804,821,7306,800,5616
13123049001,江戸川区,清新町１丁目,10480,1504,5144,774,5336,730,4017
13123049002,江戸川区,清新町２丁目,3630,117,1660,47,1970,70,1599
131230500,江戸川区,臨海町,7882,154,3972,58,3910,96,3056
13123050001,江戸川区,臨海町１丁目,2236,12,1271,3,965,9,1004
13123050002,江戸川区,臨海町２丁目,2654,81,1220,34,1434,47,963
13123050003,江戸川区,臨海町３丁目,0,0,0,0,0,0,0
13123050004,江戸川区,臨海町４丁目,138,3,121,1,17,2,126
13123050005,江戸川区,臨海町５丁目,2854,58,1360,20,1494,38,963
13123050006,江戸川区,臨海町６丁目,0,0,0,0,0,0,0
131230510,江戸川区,谷河内,3087,66,1560,31,1527,35,1217
13123051001,江戸川区,谷河内１丁目,1041,8,527,4,514,4,393
13123051002,江戸川区,谷河内２丁目,2046,58,1033,27,1013,31,824
131230520,江戸川区,東松本,3069,60,1557,26,1512,34,1253
13123052001,江戸川区,東松本１丁目,1801,40,914,17,887,23,735
13123052002,江戸川区,東松本２丁目,1268,20,643,9,625,11,518
131230530,江戸川区,西篠崎,3526,48,1809,24,1717,24,1582
13123053001,江戸川区,西篠崎１丁目,1322,21,682,10,640,11,610
13123053002,江戸川区,西篠崎２丁目,2204,27,1127,14,1077,13,972
13201,八王子市,,577513,8369,291238,3751,286275,4618,253356
132010010,八王子市,横山町,2149,91,1066,35,1083,56,1225
132010020,八王子市,八日町,2970,121,1409,47,1561,74,1557
132010030,八王子市,八幡町,1991,36,941,11,1050,25,1008
132010040,八王子市,八木町,876,23,451,10,425,13,463
132010050,八王子市,追分町,1629,67,844,34,785,33,944
132010060,八王子市,千人町,7187,151,3591,84,3596,67,4078
13201006001,八王子市,千人町１丁目,1430,42,714,25,716,17,793
13201006002,八王子市,千人町２丁目,2381,55,1181,26,1200,29,1489
13201006003,八王子市,千人町３丁目,2213,37,1078,23,1135,14,1159
13201006004,八王子市,千人町４丁目,1163,17,618,10,545,7,637
132010070,八王子市,日吉町,1085,26,548,12,537,14,570
132010080,八王子市,元本郷町,5531,86,2740,26,2791,60,2559
13201008001,八王子市,元本郷町１丁目,1562,27,808,5,754,22,766
13201008002,八王子市,元本郷町２丁目,1299,16,602,5,697,11,600
13201008003,八王子市,元本郷町３丁目,1262,15,637,7,625,8,570
13201008004,八王子市,元本郷町４丁目,1408,28,693,9,715,19,623
132010090,八王子市,平岡町,1525,50,729,20,796,30,792
132010100,八王子市,本郷町,573,17,277,5,296,12,305
132010110,八王子市,大横町,930,17,487,5,443,12,495
132010120,八王子市,本町,1899,50,945,20,954,30,1018
132010130,八王子市,元横山町,5110,139,2628,55,2482,84,2757
13201013001,八王子市,元横山町１丁目,1269,33,639,15,630,18,630
13201013002,八王子市,元横山町２丁目,1973,68,1001,26,972,42,1114
13201013003,八王子市,元横山町３丁目,1868,38,988,14,880,24,1013
132010140,八王子市,田町,270,18,173,12,97,6,181
132010150,八王子市,新町,1047,25,530,11,517,14,571
132010160,八王子市,明神町,9448,275,4673,126,4775,149,5336
13201016001,八王子市,明神町１丁目,2416,72,1232,37,1184,35,1270
13201016002,八王子市,明神町２丁目,2403,65,1165,27,1238,38,1350
13201016003,八王子市,明神町３丁目,1550,46,768,24,782,22,997
13201016004,八王子市,明神町４丁目,3079,92,1508,38,1571,54,1719
132010170,八王子市,子安町,12512,454,6398,222,6114,232,6433
13201017001,八王子市,子安町１丁目,4972,116,2476,43,2496,73,2486
13201017002,八王子市,子安町２丁目,3003,210,1548,120,1455,90,1522
13201017003,八王子市,子安町３丁目,2580,76,1448,37,1132,39,1283
13201017004,八王子市,子安町４丁目,1957,52,926,22,1031,30,1142
132010180,八王子市,東町,119,3,62,1,57,2,82
132010190,八王子市,旭町,476,13,215,6,261,7,233
132010200,八王子市,三崎町,433,22,200,12,233,10,266
132010210,八王子市,中町,352,22,187,13,165,9,276
132010220,八王子市,南町,915,50,432,19,483,31,635
132010230,八王子市,寺町,1482,63,763,16,719,47,830
132010240,八王子市,万町,2484,40,1288,17,1196,23,1247
132010250,八王子市,上野町,2891,63,1460,25,1431,38,1404
132010260,八王子市,天神町,736,14,362,5,374,9,465
132010270,八王子市,南新町,619,21,326,11,293,10,386
132010280,八王子市,小門町,1708,26,884,14,824,12,827
132010290,八王子市,台町,9834,163,4900,85,4934,78,4333
13201029001,八王子市,台町１丁目,2076,13,1010,5,1066,8,888
13201029002,八王子市,台町２丁目,2056,20,1018,7,1038,13,842
13201029003,八王子市,台町３丁目,2835,31,1447,13,1388,18,1229
13201029004,八王子市,台町４丁目,2867,99,1425,60,1442,39,1374
132010300,八王子市,中野町,4655,26,2238,12,2417,14,2019
132010310,八王子市,暁町,6211,109,3176,45,3035,64,2787
13201031001,八王子市,暁町１丁目,3173,79,1598,33,1575,46,1578
13201031002,八王子市,暁町２丁目,1990,18,1040,7,950,11,817
13201031003,八王子市,暁町３丁目,1048,12,538,5,510,7,392
132010320,八王子市,中野山王,5906,77,2854,30,3052,47,3059
13201032001,八王子市,中野山王１丁目,1387,21,727,15,660,6,727
13201032002,八王子市,中野山王２丁目,1733,34,921,6,812,28,885
13201032003,八王子市,中野山王３丁目,2786,22,1206,9,1580,13,1447
132010330,八王子市,中野上町,8343,75,4332,33,4011,42,3868
13201033001,八王子市,中野上町１丁目,1760,18,888,8,872,10,826
13201033002,八王子市,中野上町２丁目,1491,13,852,5,639,8,817
13201033003,八王子市,中野上町３丁目,1249,7,624,3,625,4,574
13201033004,八王子市,中野上町４丁目,2176,31,1106,17,1070,14,911
13201033005,八王子市,中野上町５丁目,1667,6,862,0,805,6,740
132010340,八王子市,大和田町,16682,433,8699,195,7983,238,8226
13201034001,八王子市,大和田町１丁目,3488,117,1723,63,1765,54,1648
13201034002,八王子市,大和田町２丁目,1463,17,853,10,610,7,718
13201034003,八王子市,大和田町３丁目,2512,43,1325,19,1187,24,1172
13201034004,八王子市,大和田町４丁目,1376,19,682,9,694,10,648
13201034005,八王子市,大和田町５丁目,2123,35,1071,12,1052,23,1043
13201034006,八王子市,大和田町６丁目,3753,149,2039,59,1714,90,2034
13201034007,八王子市,大和田町７丁目,1967,53,1006,23,961,30,963
132010350,八王子市,富士見町,1381,6,650,0,731,6,595
132010360,八王子市,緑町,4640,67,2526,29,2114,38,2015
132010370,八王子市,清川町,1269,10,617,3,652,7,539
132010380,八王子市,東浅川町,10709,135,5423,70,5286,65,4795
13201038000,八王子市,東浅川町,8646,99,4360,45,4286,54,3831
13201038001,八王子市,東浅川町,2063,36,1063,25,1000,11,964
132010390,八王子市,初沢町,3819,62,1924,30,1895,32,1943
132010400,八王子市,高尾町,3203,39,1722,24,1481,15,1344
132010410,八王子市,南浅川町,446,7,211,1,235,6,112
132010420,八王子市,西浅川町,698,3,343,2,355,1,266
132010430,八王子市,裏高尾町,1565,7,752,4,813,3,479
132010440,八王子市,廿里町,706,2,373,1,333,1,302
132010450,八王子市,下柚木,9374,126,4889,60,4485,66,4108
13201045000,八王子市,下柚木,2867,18,1568,9,1299,9,1229
13201045002,八王子市,下柚木２丁目,2871,14,1570,7,1301,7,1572
13201045003,八王子市,下柚木３丁目,3636,94,1751,44,1885,50,1307
132010460,八王子市,上柚木,11085,222,5445,100,5640,122,4171
13201046000,八王子市,上柚木,2616,39,1377,15,1239,24,1078
13201046002,八王子市,上柚木２丁目,2212,46,1110,23,1102,23,814
13201046003,八王子市,上柚木３丁目,6257,137,2958,62,3299,75,2279
132010470,八王子市,中山,865,4,453,1,412,3,314
132010480,八王子市,鑓水,9451,223,4615,109,4836,114,3170
13201048000,八王子市,鑓水,1833,26,888,17,945,9,645
13201048002,八王子市,鑓水２丁目,7618,197,3727,92,3891,105,2525
132010500,八王子市,南大沢,18324,327,9106,152,9218,175,8233
13201050001,八王子市,南大沢１丁目,1823,77,1020,38,803,39,1094
13201050002,八王子市,南大沢２丁目,2782,33,1485,14,1297,19,1579
13201050003,八王子市,南大沢３丁目,4199,51,1932,25,2267,26,1794
13201050004,八王子市,南大沢４丁目,4547,70,2288,33,2259,37,1966
13201050005,八王子市,南大沢５丁目,4973,96,2381,42,2592,54,1800
132010510,八王子市,越野,4110,63,2203,33,1907,30,1888
132010520,八王子市,松木,7738,98,3986,41,3752,57,3444
132010540,八王子市,別所,21678,268,10509,124,11169,144,8241
13201054001,八王子市,別所１丁目,11940,140,5822,64,6118,76,4589
13201054002,八王子市,別所２丁目,9738,128,4687,60,5051,68,3652
132010550,八王子市,南陽台,3085,15,1464,3,1621,12,1251
13201055001,八王子市,南陽台１丁目,817,5,387,1,430,4,337
13201055002,八王子市,南陽台２丁目,1365,6,643,0,722,6,547
13201055003,八王子市,南陽台３丁目,903,4,434,2,469,2,367
132010560,八王子市,堀之内,8756,139,4790,66,3966,73,4597
13201056000,八王子市,堀之内,3470,61,1762,28,1708,33,1242
13201056002,八王子市,堀之内２丁目,1623,25,1049,17,574,8,1094
13201056003,八王子市,堀之内３丁目,3663,53,1979,21,1684,32,2261
132010570,八王子市,東中野,6143,92,3581,52,2562,40,3723
132010580,八王子市,大塚,8772,115,4790,61,3982,54,4939
13201058000,八王子市,大塚,7921,111,4320,60,3601,51,4443
13201058001,八王子市,大塚,851,4,470,1,381,3,496
132010590,八王子市,鹿島,3062,27,1477,12,1585,15,1308
132010600,八王子市,松が谷,5157,80,2486,32,2671,48,2261
132010610,八王子市,並木町,3409,31,1718,12,1691,19,1542
132010620,八王子市,散田町,13689,204,6715,103,6974,101,6328
13201062001,八王子市,散田町１丁目,1966,46,938,26,1028,20,960
13201062002,八王子市,散田町２丁目,2802,17,1348,8,1454,9,1145
13201062003,八王子市,散田町３丁目,3561,70,1736,39,1825,31,1813
13201062004,八王子市,散田町４丁目,2356,33,1181,13,1175,20,1146
13201062005,八王子市,散田町５丁目,3004,38,1512,17,1492,21,1264
132010630,八王子市,山田町,2742,25,1389,14,1353,11,1166
132010640,八王子市,めじろ台,8191,54,3888,20,4303,34,3491
13201064001,八王子市,めじろ台１丁目,2256,32,1072,13,1184,19,966
13201064002,八王子市,めじろ台２丁目,2721,7,1297,1,1424,6,1229
13201064003,八王子市,めじろ台３丁目,1433,2,671,1,762,1,578
13201064004,八王子市,めじろ台４丁目,1781,13,848,5,933,8,718
132010650,八王子市,長房町,13436,156,6291,63,7145,93,6245
13201065000,八王子市,長房町,12233,150,5712,63,6521,87,5754
13201065001,八王子市,長房町,1203,6,579,0,624,6,491
132010660,八王子市,狭間町,6328,47,3116,22,3212,25,2656
132010670,八王子市,椚田町,9505,155,4837,76,4668,79,4065
13201067000,八王子市,椚田町,6884,110,3511,55,3373,55,3077
13201067001,八王子市,椚田町,2621,45,1326,21,1295,24,988
132010680,八王子市,館町,12832,209,6893,98,5939,111,5624
13201068000,八王子市,館町,9412,187,5191,92,4221,95,4181
13201068001,八王子市,館町,3420,22,1702,6,1718,16,1443
132010690,八王子市,寺田町,6395,57,3310,38,3085,19,2752
132010700,八王子市,大船町,2046,15,1029,3,1017,12,634
132010710,八王子市,大楽寺町,5260,43,2644,13,2616,30,2079
132010720,八王子市,上壱分方町,3818,19,1879,7,1939,12,1317
132010730,八王子市,諏訪町,5079,43,2565,17,2514,26,2162
132010740,八王子市,四谷町,2715,35,1382,11,1333,24,1175
132010750,八王子市,叶谷町,1789,2,872,1,917,1,669
132010760,八王子市,泉町,3297,41,1623,16,1674,25,1416
132010770,八王子市,横川町,10940,155,5443,80,5497,75,4625
13201077000,八王子市,横川町,10198,150,5069,77,5129,73,4284
13201077001,八王子市,横川町,742,5,374,3,368,2,341
132010780,八王子市,弐分方町,4323,61,2223,33,2100,28,1651
132010790,八王子市,川町,2358,3,1188,0,1170,3,906
132010800,八王子市,元八王子町,11652,92,5777,30,5875,62,4366
13201080001,八王子市,元八王子町１丁目,2165,12,1104,5,1061,7,829
13201080002,八王子市,元八王子町２丁目,5764,53,2889,11,2875,42,2051
13201080003,八王子市,元八王子町３丁目,3723,27,1784,14,1939,13,1486
132010810,八王子市,下恩方町,7016,36,3465,12,3551,24,2499
132010820,八王子市,上恩方町,767,7,395,6,372,1,299
132010830,八王子市,西寺方町,6607,39,3241,17,3366,22,2292
132010840,八王子市,小津町,217,1,109,0,108,1,94
132010850,八王子市,川口町,12468,48,6213,15,6255,33,4694
13201085000,八王子市,川口町,9875,37,4924,12,4951,25,3762
13201085001,八王子市,川口町,2593,11,1289,3,1304,8,932
132010860,八王子市,上川町,2014,9,971,2,1043,7,617
132010870,八王子市,犬目町,6662,33,3339,17,3323,16,2646
132010880,八王子市,楢原町,8435,67,4226,18,4209,49,3290
13201088000,八王子市,楢原町,7511,61,3752,18,3759,43,2947
13201088001,八王子市,楢原町,924,6,474,0,450,6,343
132010890,八王子市,美山町,3168,20,1508,10,1660,10,884
132010900,八王子市,尾崎町,112,0,66,0,46,0,51
132010910,八王子市,左入町,2013,15,1097,7,916,8,982
132010920,八王子市,滝山町,1643,158,938,82,705,76,787
13201092001,八王子市,滝山町１丁目,979,146,632,78,347,68,391
13201092002,八王子市,滝山町２丁目,664,12,306,4,358,8,396
132010930,八王子市,梅坪町,324,7,150,3,174,4,182
132010940,八王子市,谷野町,1509,42,710,10,799,32,744
132010950,八王子市,丹木町,2996,63,1599,10,1397,53,1590
13201095001,八王子市,丹木町１丁目,1536,22,865,7,671,15,789
13201095002,八王子市,丹木町２丁目,815,6,438,3,377,3,450
13201095003,八王子市,丹木町３丁目,645,35,296,0,349,35,351
132010960,八王子市,加住町,603,2,326,1,277,1,335
13201096001,八王子市,加住町１丁目,468,2,268,1,200,1,255
13201096002,八王子市,加住町２丁目,135,0,58,0,77,0,80
132010970,八王子市,宮下町,2076,30,1012,10,1064,20,573
132010980,八王子市,戸吹町,1852,14,945,5,907,9,605
132010990,八王子市,高月町,374,0,198,0,176,0,131
132011000,八王子市,小比企町,6904,81,3507,40,3397,41,2996
132011010,八王子市,片倉町,12977,105,6666,53,6311,52,5774
13201101000,八王子市,片倉町,10186,82,5198,40,4988,42,4584
13201101001,八王子市,片倉町,2791,23,1468,13,1323,10,1190
132011020,八王子市,宇津貫町,60,0,30,0,30,0,21
132011030,八王子市,北野町,7759,239,4102,108,3657,131,4207
132011050,八王子市,打越町,9325,114,4626,41,4699,73,4282
13201105000,八王子市,打越町,7618,105,3805,38,3813,67,3484
13201105001,八王子市,打越町,1707,9,821,3,886,6,798
132011060,八王子市,長沼町,7749,93,3804,33,3945,60,3535
132011070,八王子市,絹ケ丘,5931,49,2851,19,3080,30,2479
13201107001,八王子市,絹ケ丘１丁目,2264,19,1081,7,1183,12,965
13201107002,八王子市,絹ケ丘２丁目,2028,23,983,10,1045,13,836
13201107003,八王子市,絹ケ丘３丁目,1639,7,787,2,852,5,678
132011080,八王子市,北野台,6923,29,3297,13,3626,16,2708
13201108001,八王子市,北野台１丁目,1418,8,649,4,769,4,563
13201108002,八王子市,北野台２丁目,1211,3,580,0,631,3,489
13201108003,八王子市,北野台３丁目,1484,5,694,1,790,4,604
13201108004,八王子市,北野台４丁目,1103,5,536,4,567,1,437
13201108005,八王子市,北野台５丁目,1707,8,838,4,869,4,615
132011090,八王子市,高倉町,3345,65,1741,32,1604,33,1506
132011100,八王子市,石川町,10582,99,5527,34,5055,65,4436
13201110000,八王子市,石川町,10571,99,5522,34,5049,65,4435
13201110001,八王子市,石川町,11,0,5,0,6,0,1
132011110,八王子市,宇津木町,3322,32,1691,22,1631,10,1254
132011120,八王子市,平町,429,1,221,1,208,0,166
132011130,八王子市,小宮町,5349,42,2746,15,2603,27,2092
132011140,八王子市,久保山町,5250,39,2634,14,2616,25,1992
13201114001,八王子市,久保山町１丁目,2646,6,1340,1,1306,5,1012
13201114002,八王子市,久保山町２丁目,2604,33,1294,13,1310,20,980
132011150,八王子市,大谷町,3550,58,1825,23,1725,35,1522
132011160,八王子市,丸山町,1190,4,600,2,590,2,448
132011170,八王子市,みつい台,2272,12,1095,4,1177,8,905
13201117001,八王子市,みつい台１丁目,761,2,360,1,401,1,303
13201117002,八王子市,みつい台２丁目,1511,10,735,3,776,7,602
132011180,八王子市,城山手,1915,2,924,1,991,1,595
13201118001,八王子市,城山手１丁目,991,1,480,1,511,0,296
13201118002,八王子市,城山手２丁目,924,1,444,0,480,1,299
132011210,八王子市,みなみ野,10501,111,5444,65,5057,46,3533
13201121001,八王子市,みなみ野１丁目,2531,22,1491,15,1040,7,591
13201121002,八王子市,みなみ野２丁目,912,15,462,12,450,3,364
13201121003,八王子市,みなみ野３丁目,1914,29,952,16,962,13,707
13201121004,八王子市,みなみ野４丁目,2252,32,1128,18,1124,14,885
13201121005,八王子市,みなみ野５丁目,2244,13,1106,4,1138,9,756
13201121006,八王子市,みなみ野６丁目,648,0,305,0,343,0,230
132011220,八王子市,西片倉,2774,38,1388,18,1386,20,1281
13201122001,八王子市,西片倉１丁目,650,11,336,5,314,6,306
13201122002,八王子市,西片倉２丁目,1140,18,565,10,575,8,520
13201122003,八王子市,西片倉３丁目,984,9,487,3,497,6,455
132011230,八王子市,兵衛,2308,41,1205,19,1103,22,957
13201123001,八王子市,兵衛１丁目,1382,24,722,12,660,12,567
13201123002,八王子市,兵衛２丁目,926,17,483,7,443,10,390
132011240,八王子市,七国,9824,74,4881,28,4943,46,3230
13201124001,八王子市,七国１丁目,1070,12,553,4,517,8,553
13201124002,八王子市,七国２丁目,1273,10,636,6,637,4,447
13201124003,八王子市,七国３丁目,1173,6,584,1,589,5,345
13201124004,八王子市,七国４丁目,2174,17,1045,5,1129,12,603
13201124005,八王子市,七国５丁目,2076,20,1016,9,1060,11,613
13201124006,八王子市,七国６丁目,2058,9,1047,3,1011,6,669
13202,立川市,,176295,2393,86978,1077,89317,1316,83285
132020010,立川市,西砂町,9333,81,4656,36,4677,45,3572
13202001001,立川市,西砂町１丁目,2017,21,991,9,1026,12,820
13202001002,立川市,西砂町２丁目,2008,14,998,7,1010,7,776
13202001003,立川市,西砂町３丁目,848,3,419,0,429,3,319
13202001004,立川市,西砂町４丁目,584,3,306,2,278,1,201
13202001005,立川市,西砂町５丁目,2556,23,1283,12,1273,11,940
13202001006,立川市,西砂町６丁目,1320,17,659,6,661,11,516
13202001007,立川市,西砂町７丁目,0,0,0,0,0,0,0
132020020,立川市,一番町,12687,247,6327,110,6360,137,5567
13202002001,立川市,一番町１丁目,2383,35,1229,14,1154,21,1053
13202002002,立川市,一番町２丁目,2148,28,1086,10,1062,18,870
13202002003,立川市,一番町３丁目,961,15,482,4,479,11,368
13202002004,立川市,一番町４丁目,2289,37,1158,18,1131,19,1011
13202002005,立川市,一番町５丁目,1920,89,905,45,1015,44,1046
13202002006,立川市,一番町６丁目,2986,43,1467,19,1519,24,1219
132020030,立川市,上砂町,10745,161,5050,66,5695,95,4644
13202003001,立川市,上砂町１丁目,3542,103,1547,42,1995,61,1663
13202003002,立川市,上砂町２丁目,828,7,412,4,416,3,302
13202003003,立川市,上砂町３丁目,1468,12,705,3,763,9,617
13202003004,立川市,上砂町４丁目,660,2,332,1,328,1,277
13202003005,立川市,上砂町５丁目,4247,37,2054,16,2193,21,1785
13202003006,立川市,上砂町６丁目,0,0,0,0,0,0,0
13202003007,立川市,上砂町７丁目,0,0,0,0,0,0,0
132020040,立川市,砂川町,16175,102,8113,43,8062,59,6754
13202004001,立川市,砂川町１丁目,1207,13,617,8,590,5,463
13202004002,立川市,砂川町２丁目,1849,9,905,4,944,5,727
13202004003,立川市,砂川町３丁目,1155,10,594,4,561,6,495
13202004004,立川市,砂川町４丁目,2376,19,1216,9,1160,10,947
13202004005,立川市,砂川町５丁目,890,3,437,0,453,3,417
13202004006,立川市,砂川町６丁目,1862,9,907,4,955,5,819
13202004007,立川市,砂川町７丁目,2847,11,1402,3,1445,8,1168
13202004008,立川市,砂川町８丁目,3989,28,2035,11,1954,17,1718
132020050,立川市,緑町,2307,6,1209,2,1098,4,1072
132020060,立川市,泉町,2150,29,1304,14,846,15,551
132020070,立川市,柏町,9379,67,4415,38,4964,29,4450
13202007001,立川市,柏町１丁目,2108,35,979,20,1129,15,934
13202007002,立川市,柏町２丁目,867,2,433,1,434,1,366
13202007003,立川市,柏町３丁目,1532,12,781,11,751,1,803
13202007004,立川市,柏町４丁目,4274,17,1994,6,2280,11,2147
13202007005,立川市,柏町５丁目,598,1,228,0,370,1,200
132020080,立川市,幸町,13251,112,6476,40,6775,72,6125
13202008001,立川市,幸町１丁目,1106,9,544,4,562,5,500
13202008002,立川市,幸町２丁目,2904,21,1386,10,1518,11,1310
13202008003,立川市,幸町３丁目,1347,7,675,1,672,6,594
13202008004,立川市,幸町４丁目,3575,58,1756,18,1819,40,1627
13202008005,立川市,幸町５丁目,3027,7,1487,3,1540,4,1476
13202008006,立川市,幸町６丁目,1292,10,628,4,664,6,618
132020090,立川市,若葉町,12021,126,5701,56,6320,70,5332
13202009001,立川市,若葉町１丁目,4730,42,2238,21,2492,21,2103
13202009002,立川市,若葉町２丁目,2029,22,963,8,1066,14,792
13202009003,立川市,若葉町３丁目,2175,21,1053,8,1122,13,811
13202009004,立川市,若葉町４丁目,3087,41,1447,19,1640,22,1626
132020100,立川市,栄町,12261,153,6039,74,6222,79,5409
13202010001,立川市,栄町１丁目,2012,6,1097,2,915,4,801
13202010002,立川市,栄町２丁目,2251,14,1117,4,1134,10,852
13202010003,立川市,栄町３丁目,1381,7,659,3,722,4,594
13202010004,立川市,栄町４丁目,2110,21,1052,11,1058,10,1053
13202010005,立川市,栄町５丁目,3058,72,1412,35,1646,37,1458
13202010006,立川市,栄町６丁目,1449,33,702,19,747,14,651
132020110,立川市,高松町,9832,255,5195,139,4637,116,5732
13202011001,立川市,高松町１丁目,2546,45,1328,21,1218,24,1511
13202011002,立川市,高松町２丁目,4036,114,2135,55,1901,59,2384
13202011003,立川市,高松町３丁目,3250,96,1732,63,1518,33,1837
132020120,立川市,曙町,11023,222,5467,96,5556,126,6090
13202012001,立川市,曙町１丁目,3859,69,1920,29,1939,40,2170
13202012002,立川市,曙町２丁目,2323,54,1130,19,1193,35,1326
13202012003,立川市,曙町３丁目,4841,99,2417,48,2424,51,2594
132020130,立川市,羽衣町,9256,141,4468,63,4788,78,4807
13202013001,立川市,羽衣町１丁目,3131,59,1498,25,1633,34,1667
13202013002,立川市,羽衣町２丁目,4264,47,2082,21,2182,26,2164
13202013003,立川市,羽衣町３丁目,1861,35,888,17,973,18,976
132020140,立川市,錦町,17209,342,8626,159,8583,183,9268
13202014001,立川市,錦町１丁目,5167,119,2755,61,2412,58,3238
13202014002,立川市,錦町２丁目,2434,36,1218,19,1216,17,1475
13202014003,立川市,錦町３丁目,1974,50,920,22,1054,28,1076
13202014004,立川市,錦町４丁目,1091,30,546,9,545,21,580
13202014005,立川市,錦町５丁目,2392,45,1178,21,1214,24,1008
13202014006,立川市,錦町６丁目,4151,62,2009,27,2142,35,1891
132020150,立川市,柴崎町,9865,122,4852,54,5013,68,4924
13202015001,立川市,柴崎町１丁目,2197,31,1116,12,1081,19,1029
13202015002,立川市,柴崎町２丁目,2349,30,1127,13,1222,17,1342
13202015003,立川市,柴崎町３丁目,1516,20,752,11,764,9,870
13202015004,立川市,柴崎町４丁目,2049,23,998,11,1051,12,914
13202015005,立川市,柴崎町５丁目,1037,9,510,3,527,6,452
13202015006,立川市,柴崎町６丁目,717,9,349,4,368,5,317
132020160,立川市,富士見町,18801,227,9080,87,9721,140,8988
13202016001,立川市,富士見町１丁目,3869,35,1833,11,2036,24,1906
13202016002,立川市,富士見町２丁目,2902,33,1400,19,1502,14,1501
13202016003,立川市,富士見町３丁目,818,6,411,1,407,5,397
13202016004,立川市,富士見町４丁目,1516,24,757,12,759,12,740
13202016005,立川市,富士見町５丁目,1205,12,557,4,648,8,578
13202016006,立川市,富士見町６丁目,4981,84,2439,30,2542,54,2536
13202016007,立川市,富士見町７丁目,3510,33,1683,10,1827,23,1330
13203,武蔵野市,,144730,2136,69475,1038,75255,1098,74022
132030010,武蔵野市,吉祥寺東町,12617,184,6087,96,6530,88,6703
13203001001,武蔵野市,吉祥寺東町１丁目,2944,41,1458,16,1486,25,1767
13203001002,武蔵野市,吉祥寺東町２丁目,4565,99,2190,52,2375,47,2426
13203001003,武蔵野市,吉祥寺東町３丁目,3624,28,1743,18,1881,10,1771
13203001004,武蔵野市,吉祥寺東町４丁目,1484,16,696,10,788,6,739
132030020,武蔵野市,吉祥寺南町,13562,245,6498,153,7064,92,7492
13203002001,武蔵野市,吉祥寺南町１丁目,2282,45,1065,22,1217,23,1210
13203002002,武蔵野市,吉祥寺南町２丁目,2762,62,1306,40,1456,22,1674
13203002003,武蔵野市,吉祥寺南町３丁目,3729,63,1772,42,1957,21,2015
13203002004,武蔵野市,吉祥寺南町４丁目,3082,48,1481,31,1601,17,1667
13203002005,武蔵野市,吉祥寺南町５丁目,1707,27,874,18,833,9,926
132030030,武蔵野市,御殿山,4339,82,2060,43,2279,39,2417
13203003001,武蔵野市,御殿山１丁目,2303,51,1060,27,1243,24,1313
13203003002,武蔵野市,御殿山２丁目,2036,31,1000,16,1036,15,1104
132030040,武蔵野市,吉祥寺本町,11669,230,5520,109,6149,121,7201
13203004001,武蔵野市,吉祥寺本町１丁目,2014,62,1020,29,994,33,1339
13203004002,武蔵野市,吉祥寺本町２丁目,2864,67,1333,32,1531,35,2003
13203004003,武蔵野市,吉祥寺本町３丁目,2953,55,1412,25,1541,30,1747
13203004004,武蔵野市,吉祥寺本町４丁目,3838,46,1755,23,2083,23,2112
132030050,武蔵野市,吉祥寺北町,16167,154,7788,78,8379,76,7377
13203005001,武蔵野市,吉祥寺北町１丁目,3762,32,1829,16,1933,16,2000
13203005002,武蔵野市,吉祥寺北町２丁目,3336,20,1563,10,1773,10,1294
13203005003,武蔵野市,吉祥寺北町３丁目,3903,55,1912,28,1991,27,1815
13203005004,武蔵野市,吉祥寺北町４丁目,3484,35,1673,18,1811,17,1548
13203005005,武蔵野市,吉祥寺北町５丁目,1682,12,811,6,871,6,720
132030060,武蔵野市,中町,13966,178,6635,85,7331,93,7602
13203006001,武蔵野市,中町１丁目,3772,48,1720,21,2052,27,2102
13203006002,武蔵野市,中町２丁目,4446,54,2178,28,2268,26,2532
13203006003,武蔵野市,中町３丁目,5748,76,2737,36,3011,40,2968
132030070,武蔵野市,西久保,11702,143,5746,74,5956,69,6318
13203007001,武蔵野市,西久保１丁目,2518,30,1151,17,1367,13,1215
13203007002,武蔵野市,西久保２丁目,4406,42,2234,20,2172,22,2423
13203007003,武蔵野市,西久保３丁目,4778,71,2361,37,2417,34,2680
132030080,武蔵野市,緑町,8382,135,3883,64,4499,71,3727
13203008001,武蔵野市,緑町１丁目,2153,21,1067,11,1086,10,1017
13203008002,武蔵野市,緑町２丁目,5499,99,2475,46,3024,53,2398
13203008003,武蔵野市,緑町３丁目,730,15,341,7,389,8,312
132030090,武蔵野市,八幡町,4384,49,2206,24,2178,25,1864
13203009001,武蔵野市,八幡町１丁目,1237,14,639,6,598,8,597
13203009002,武蔵野市,八幡町２丁目,732,15,388,9,344,6,254
13203009003,武蔵野市,八幡町３丁目,1471,12,721,6,750,6,601
13203009004,武蔵野市,八幡町４丁目,944,8,458,3,486,5,412
132030100,武蔵野市,関前,9244,123,4516,57,4728,66,4223
13203010001,武蔵野市,関前１丁目,487,13,249,8,238,5,246
13203010002,武蔵野市,関前２丁目,2460,32,1232,18,1228,14,1145
13203010003,武蔵野市,関前３丁目,3210,34,1534,10,1676,24,1290
13203010004,武蔵野市,関前４丁目,1459,11,726,4,733,7,728
13203010005,武蔵野市,関前５丁目,1628,33,775,17,853,16,814
132030110,武蔵野市,境,15589,237,7604,106,7985,131,7972
13203011001,武蔵野市,境１丁目,3343,50,1620,16,1723,34,1964
13203011002,武蔵野市,境２丁目,3867,49,1896,19,1971,30,2064
13203011003,武蔵野市,境３丁目,1792,27,874,12,918,15,816
13203011004,武蔵野市,境４丁目,2002,21,993,12,1009,9,927
13203011005,武蔵野市,境５丁目,4585,90,2221,47,2364,43,2201
132030120,武蔵野市,境南町,14276,241,6744,80,7532,161,7495
13203012001,武蔵野市,境南町１丁目,2186,24,1053,9,1133,15,1173
13203012002,武蔵野市,境南町２丁目,4620,91,2073,27,2547,64,2448
13203012003,武蔵野市,境南町３丁目,2520,44,1224,17,1296,27,1309
13203012004,武蔵野市,境南町４丁目,2738,46,1337,17,1401,29,1458
13203012005,武蔵野市,境南町５丁目,2212,36,1057,10,1155,26,1107
132030130,武蔵野市,桜堤,8833,135,4188,69,4645,66,3631
13203013001,武蔵野市,桜堤１丁目,2646,61,1240,36,1406,25,1307
13203013002,武蔵野市,桜堤２丁目,5088,65,2409,30,2679,35,1856
13203013003,武蔵野市,桜堤３丁目,1099,9,539,3,560,6,468
13204,三鷹市,,186936,2741,90641,1308,96295,1433,90226
132040010,三鷹市,下連雀,44622,540,20954,228,23668,312,21860
13204001001,三鷹市,下連雀１丁目,3017,27,1469,14,1548,13,1537
13204001002,三鷹市,下連雀２丁目,3493,27,1717,13,1776,14,1794
13204001003,三鷹市,下連雀３丁目,10210,185,4661,76,5549,109,6322
13204001004,三鷹市,下連雀４丁目,6065,93,2875,42,3190,51,3202
13204001005,三鷹市,下連雀５丁目,4041,26,1771,13,2270,13,1404
13204001006,三鷹市,下連雀６丁目,4204,45,2012,18,2192,27,1983
13204001007,三鷹市,下連雀７丁目,4844,63,2274,20,2570,43,2201
13204001008,三鷹市,下連雀８丁目,3770,24,1796,11,1974,13,1500
13204001009,三鷹市,下連雀９丁目,4978,50,2379,21,2599,29,1917
132040020,三鷹市,牟礼,20749,306,10129,144,10620,162,9872
13204002001,三鷹市,牟礼１丁目,2070,24,977,9,1093,15,1014
13204002002,三鷹市,牟礼２丁目,3863,64,1817,32,2046,32,1945
13204002003,三鷹市,牟礼３丁目,1428,21,792,13,636,8,796
13204002004,三鷹市,牟礼４丁目,3375,82,1618,35,1757,47,1482
13204002005,三鷹市,牟礼５丁目,2734,53,1351,21,1383,32,1340
13204002006,三鷹市,牟礼６丁目,5499,44,2681,23,2818,21,2475
13204002007,三鷹市,牟礼７丁目,1780,18,893,11,887,7,820
132040030,三鷹市,井の頭,16026,327,7683,168,8343,159,8685
13204003001,三鷹市,井の頭１丁目,4763,46,2215,30,2548,16,2607
13204003002,三鷹市,井の頭２丁目,3574,80,1662,39,1912,41,2124
13204003003,三鷹市,井の頭３丁目,2330,59,1088,33,1242,26,1196
13204003004,三鷹市,井の頭４丁目,1971,51,997,26,974,25,1051
13204003005,三鷹市,井の頭５丁目,3388,91,1721,40,1667,51,1707
132040040,三鷹市,中原,14512,167,6995,72,7517,95,6718
13204004001,三鷹市,中原１丁目,4246,45,2018,23,2228,22,2055
13204004002,三鷹市,中原２丁目,3022,27,1477,12,1545,15,1388
13204004003,三鷹市,中原３丁目,3180,43,1542,14,1638,29,1466
13204004004,三鷹市,中原４丁目,4064,52,1958,23,2106,29,1809
132040050,三鷹市,北野,7865,45,3863,24,4002,21,3648
13204005001,三鷹市,北野１丁目,1537,5,711,3,826,2,710
13204005002,三鷹市,北野２丁目,2075,9,1036,6,1039,3,925
13204005003,三鷹市,北野３丁目,2177,14,1107,8,1070,6,941
13204005004,三鷹市,北野４丁目,2076,17,1009,7,1067,10,1072
132040060,三鷹市,新川,16644,378,8220,199,8424,179,8371
13204006001,三鷹市,新川１丁目,2132,20,1046,10,1086,10,1012
13204006002,三鷹市,新川２丁目,1514,12,742,7,772,5,664
13204006003,三鷹市,新川３丁目,2119,26,1097,14,1022,12,1026
13204006004,三鷹市,新川４丁目,3315,48,1579,26,1736,22,1523
13204006005,三鷹市,新川５丁目,2623,50,1225,25,1398,25,1188
13204006006,三鷹市,新川６丁目,4941,222,2531,117,2410,105,2958
132040070,三鷹市,上連雀,26009,289,12693,136,13316,153,12969
13204007001,三鷹市,上連雀１丁目,3124,27,1607,14,1517,13,1832
13204007002,三鷹市,上連雀２丁目,2389,12,1156,5,1233,7,1386
13204007003,三鷹市,上連雀３丁目,1651,22,834,12,817,10,956
13204007004,三鷹市,上連雀４丁目,3408,30,1663,14,1745,16,1630
13204007005,三鷹市,上連雀５丁目,2737,23,1362,12,1375,11,1399
13204007006,三鷹市,上連雀６丁目,3109,53,1461,20,1648,33,1483
13204007007,三鷹市,上連雀７丁目,2837,32,1343,18,1494,14,1328
13204007008,三鷹市,上連雀８丁目,3490,50,1672,26,1818,24,1507
13204007009,三鷹市,上連雀９丁目,3264,40,1595,15,1669,25,1448
132040080,三鷹市,井口,12552,186,6139,88,6413,98,5841
13204008001,三鷹市,井口１丁目,3844,59,1947,35,1897,24,1870
13204008002,三鷹市,井口２丁目,2407,20,1145,10,1262,10,1032
13204008003,三鷹市,井口３丁目,2224,32,1026,10,1198,22,1024
13204008004,三鷹市,井口４丁目,3110,55,1561,24,1549,31,1455
13204008005,三鷹市,井口５丁目,967,20,460,9,507,11,460
132040090,三鷹市,深大寺,7958,121,4093,78,3865,43,3892
13204009001,三鷹市,深大寺１丁目,1677,18,843,8,834,10,793
13204009002,三鷹市,深大寺２丁目,4175,84,2163,61,2012,23,1996
13204009003,三鷹市,深大寺３丁目,2106,19,1087,9,1019,10,1103
132040100,三鷹市,野崎,6254,58,3134,28,3120,30,2924
13204010001,三鷹市,野崎１丁目,1077,10,506,6,571,4,524
13204010002,三鷹市,野崎２丁目,2531,24,1278,11,1253,13,1186
13204010003,三鷹市,野崎３丁目,2089,19,1033,7,1056,12,937
13204010004,三鷹市,野崎４丁目,557,5,317,4,240,1,277
132040110,三鷹市,大沢,13745,324,6738,143,7007,181,5446
13204011001,三鷹市,大沢１丁目,2831,45,1439,20,1392,25,1156
13204011002,三鷹市,大沢２丁目,2271,27,1156,14,1115,13,871
13204011003,三鷹市,大沢３丁目,2132,199,951,84,1181,115,653
13204011004,三鷹市,大沢４丁目,2994,10,1447,6,1547,4,1250
13204011005,三鷹市,大沢５丁目,1978,16,984,9,994,7,788
13204011006,三鷹市,大沢６丁目,1539,27,761,10,778,17,728
13205,青梅市,,137381,1416,68677,557,68704,859,54371
132050010,青梅市,東青梅,8656,114,4273,39,4383,75,4151
13205001001,青梅市,東青梅１丁目,936,11,424,4,512,7,446
13205001002,青梅市,東青梅２丁目,1558,14,752,3,806,11,766
13205001003,青梅市,東青梅３丁目,2136,21,1061,13,1075,8,987
13205001004,青梅市,東青梅４丁目,1337,20,675,6,662,14,699
13205001005,青梅市,東青梅５丁目,1842,41,915,10,927,31,886
13205001006,青梅市,東青梅６丁目,847,7,446,3,401,4,367
132050020,青梅市,根ヶ布,2356,17,1119,3,1237,14,916
13205002001,青梅市,根ヶ布１丁目,863,5,437,2,426,3,371
13205002002,青梅市,根ヶ布２丁目,1493,12,682,1,811,11,545
132050030,青梅市,師岡町,4345,41,2220,11,2125,30,1921
13205003001,青梅市,師岡町１丁目,783,0,404,0,379,0,300
13205003002,青梅市,師岡町２丁目,1573,7,781,2,792,5,644
13205003003,青梅市,師岡町３丁目,1110,11,584,3,526,8,529
13205003004,青梅市,師岡町４丁目,879,23,451,6,428,17,448
132050040,青梅市,勝沼,1998,11,994,2,1004,9,833
13205004001,青梅市,勝沼１丁目,542,2,266,1,276,1,225
13205004002,青梅市,勝沼２丁目,796,5,398,1,398,4,344
13205004003,青梅市,勝沼３丁目,660,4,330,0,330,4,264
132050050,青梅市,西分町,778,5,385,1,393,4,350
13205005001,青梅市,西分町１丁目,291,3,155,1,136,2,142
13205005002,青梅市,西分町２丁目,171,0,81,0,90,0,89
13205005003,青梅市,西分町３丁目,316,2,149,0,167,2,119
132050070,青梅市,日向和田,1764,4,854,2,910,2,702
13205007001,青梅市,日向和田１丁目,426,1,198,0,228,1,183
13205007002,青梅市,日向和田２丁目,601,3,291,2,310,1,246
13205007003,青梅市,日向和田３丁目,737,0,365,0,372,0,273
132050080,青梅市,駒木町,1963,9,960,2,1003,7,721
13205008001,青梅市,駒木町１丁目,543,5,266,0,277,5,206
13205008002,青梅市,駒木町２丁目,799,4,400,2,399,2,325
13205008003,青梅市,駒木町３丁目,621,0,294,0,327,0,190
132050090,青梅市,長淵,9208,63,4563,27,4645,36,3250
13205009001,青梅市,長淵１丁目,1352,5,661,3,691,2,447
13205009002,青梅市,長淵２丁目,1709,5,866,2,843,3,656
13205009003,青梅市,長淵３丁目,994,12,492,4,502,8,353
13205009004,青梅市,長淵４丁目,1753,15,823,6,930,9,625
13205009005,青梅市,長淵５丁目,1376,13,682,5,694,8,345
13205009006,青梅市,長淵６丁目,398,2,197,0,201,2,142
13205009007,青梅市,長淵７丁目,951,7,501,5,450,2,449
13205009008,青梅市,長淵８丁目,562,4,288,2,274,2,228
13205009009,青梅市,長淵９丁目,113,0,53,0,60,0,5
132050100,青梅市,友田町,3635,46,1802,21,1833,25,1335
13205010001,青梅市,友田町１丁目,659,10,335,6,324,4,262
13205010002,青梅市,友田町２丁目,637,7,332,4,305,3,240
13205010003,青梅市,友田町３丁目,902,18,434,8,468,10,284
13205010004,青梅市,友田町４丁目,729,5,360,1,369,4,269
13205010005,青梅市,友田町５丁目,708,6,341,2,367,4,280
132050120,青梅市,河辺町,15561,275,7839,88,7722,187,7312
13205012001,青梅市,河辺町１丁目,1743,18,876,1,867,17,747
13205012002,青梅市,河辺町２丁目,683,0,357,0,326,0,268
13205012003,青梅市,河辺町３丁目,517,6,253,2,264,4,206
13205012004,青梅市,河辺町４丁目,1436,37,729,10,707,27,713
13205012005,青梅市,河辺町５丁目,1449,31,721,8,728,23,669
13205012006,青梅市,河辺町６丁目,2561,49,1297,17,1264,32,1135
13205012007,青梅市,河辺町７丁目,2213,49,1076,18,1137,31,1050
13205012008,青梅市,河辺町８丁目,1609,21,876,8,733,13,769
13205012009,青梅市,河辺町９丁目,1810,40,860,15,950,25,897
13205012010,青梅市,河辺町１０丁目,1540,24,794,9,746,15,858
132050130,青梅市,千ヶ瀬町,6525,53,3333,25,3192,28,2676
13205013001,青梅市,千ヶ瀬町１丁目,1480,13,734,6,746,7,621
13205013002,青梅市,千ヶ瀬町２丁目,1216,9,618,5,598,4,488
13205013003,青梅市,千ヶ瀬町３丁目,919,6,493,4,426,2,324
13205013004,青梅市,千ヶ瀬町４丁目,914,4,503,1,411,3,417
13205013005,青梅市,千ヶ瀬町５丁目,1155,10,572,3,583,7,466
13205013006,青梅市,千ヶ瀬町６丁目,841,11,413,6,428,5,360
132050140,青梅市,吹上,1311,5,634,2,677,3,467
132050160,青梅市,野上町,6588,94,3395,42,3193,52,2960
13205016001,青梅市,野上町１丁目,771,0,398,0,373,0,284
13205016002,青梅市,野上町２丁目,1356,14,696,5,660,9,556
13205016003,青梅市,野上町３丁目,2930,49,1506,24,1424,25,1405
13205016004,青梅市,野上町４丁目,1531,31,795,13,736,18,715
132050180,青梅市,大門,4911,56,2273,15,2638,41,1669
13205018001,青梅市,大門１丁目,2467,14,1055,4,1412,10,740
13205018002,青梅市,大門２丁目,785,29,395,9,390,20,293
13205018003,青梅市,大門３丁目,1659,13,823,2,836,11,636
132050190,青梅市,塩船,856,2,385,0,471,2,277
132050200,青梅市,谷野,1018,5,489,1,529,4,372
132050210,青梅市,木野下,1293,15,643,7,650,8,466
13205021001,青梅市,木野下１丁目,655,10,325,5,330,5,243
13205021002,青梅市,木野下２丁目,638,5,318,2,320,3,223
132050230,青梅市,今寺,5129,45,2624,20,2505,25,1802
13205023001,青梅市,今寺１丁目,1370,17,696,8,674,9,455
13205023002,青梅市,今寺２丁目,261,5,137,3,124,2,96
13205023003,青梅市,今寺３丁目,847,8,442,4,405,4,309
13205023004,青梅市,今寺４丁目,1424,9,731,3,693,6,515
13205023005,青梅市,今寺５丁目,1227,6,618,2,609,4,427
132050250,青梅市,末広町,1426,21,679,7,747,14,426
13205025001,青梅市,末広町１丁目,650,1,291,0,359,1,86
13205025002,青梅市,末広町２丁目,776,20,388,7,388,13,340
132050270,青梅市,藤橋,3729,39,1889,18,1840,21,1386
13205027001,青梅市,藤橋１丁目,400,9,194,5,206,4,175
13205027002,青梅市,藤橋２丁目,2480,20,1275,7,1205,13,893
13205027003,青梅市,藤橋３丁目,849,10,420,6,429,4,318
132050290,青梅市,今井,7701,49,3712,20,3989,29,2406
13205029001,青梅市,今井１丁目,3339,29,1618,12,1721,17,1003
13205029002,青梅市,今井２丁目,2239,11,1079,3,1160,8,711
13205029003,青梅市,今井３丁目,1918,9,965,5,953,4,673
13205029004,青梅市,今井４丁目,0,0,0,0,0,0,0
13205029005,青梅市,今井５丁目,205,0,50,0,155,0,19
132050300,青梅市,畑中,2761,22,1388,8,1373,14,1058
13205030001,青梅市,畑中１丁目,789,9,413,4,376,5,301
13205030002,青梅市,畑中２丁目,936,6,454,2,482,4,377
13205030003,青梅市,畑中３丁目,1036,7,521,2,515,5,380
132050310,青梅市,和田町,1164,7,579,7,585,0,442
13205031001,青梅市,和田町１丁目,513,7,261,7,252,0,197
13205031002,青梅市,和田町２丁目,651,0,318,0,333,0,245
132050320,青梅市,梅郷,4164,19,2100,8,2064,11,1558
13205032001,青梅市,梅郷１丁目,423,1,212,0,211,1,153
13205032002,青梅市,梅郷２丁目,377,2,178,0,199,2,137
13205032003,青梅市,梅郷３丁目,419,0,215,0,204,0,156
13205032004,青梅市,梅郷４丁目,498,0,247,0,251,0,198
13205032005,青梅市,梅郷５丁目,1232,6,604,4,628,2,462
13205032006,青梅市,梅郷６丁目,1215,10,644,4,571,6,452
132050330,青梅市,柚木町,2308,10,1082,6,1226,4,789
13205033001,青梅市,柚木町１丁目,839,7,418,6,421,1,315
13205033002,青梅市,柚木町２丁目,954,3,406,0,548,3,286
13205033003,青梅市,柚木町３丁目,515,0,258,0,257,0,188
132050340,青梅市,二俣尾,2052,11,1005,5,1047,6,803
13205034001,青梅市,二俣尾１丁目,207,3,105,1,102,2,90
13205034002,青梅市,二俣尾２丁目,721,5,354,3,367,2,280
13205034003,青梅市,二俣尾３丁目,630,3,304,1,326,2,234
13205034004,青梅市,二俣尾４丁目,265,0,128,0,137,0,111
13205034005,青梅市,二俣尾５丁目,229,0,114,0,115,0,88
132050350,青梅市,沢井,650,5,324,3,326,2,269
13205035001,青梅市,沢井１丁目,153,5,75,3,78,2,55
13205035002,青梅市,沢井２丁目,279,0,137,0,142,0,111
13205035003,青梅市,沢井３丁目,218,0,112,0,106,0,103
132050360,青梅市,御岳本町,365,0,167,0,198,0,122
132050370,青梅市,御岳,220,0,112,0,108,0,97
13205037001,青梅市,御岳１丁目,95,0,45,0,50,0,49
13205037002,青梅市,御岳２丁目,125,0,67,0,58,0,48
132050380,青梅市,御岳山,134,0,61,0,73,0,36
132050390,青梅市,富岡,1409,7,679,4,730,3,328
13205039001,青梅市,富岡１丁目,564,2,248,1,316,1,121
13205039002,青梅市,富岡２丁目,189,3,95,1,94,2,77
13205039003,青梅市,富岡３丁目,656,2,336,2,320,0,130
132050400,青梅市,小曾木,1394,3,661,2,733,1,450
13205040001,青梅市,小曾木１丁目,278,0,144,0,134,0,69
13205040002,青梅市,小曾木２丁目,112,0,56,0,56,0,46
13205040003,青梅市,小曾木３丁目,410,1,205,1,205,0,152
13205040004,青梅市,小曾木４丁目,426,2,178,1,248,1,117
13205040005,青梅市,小曾木５丁目,168,0,78,0,90,0,66
132050410,青梅市,黒沢,1718,3,746,1,972,2,468
13205041001,青梅市,黒沢１丁目,628,1,256,0,372,1,118
13205041002,青梅市,黒沢２丁目,567,2,289,1,278,1,222
13205041003,青梅市,黒沢３丁目,523,0,201,0,322,0,128
132050420,青梅市,成木,2468,12,1216,4,1252,8,644
13205042001,青梅市,成木１丁目,724,5,330,2,394,3,139
13205042002,青梅市,成木２丁目,577,2,274,2,303,0,119
13205042003,青梅市,成木３丁目,243,0,122,0,121,0,97
13205042004,青梅市,成木４丁目,323,1,180,0,143,1,42
13205042005,青梅市,成木５丁目,146,3,72,0,74,3,66
13205042006,青梅市,成木６丁目,91,1,45,0,46,1,34
13205042007,青梅市,成木７丁目,160,0,81,0,79,0,61
13205042008,青梅市,成木８丁目,204,0,112,0,92,0,86
132050440,青梅市,住江町,555,3,265,2,290,1,272
132050450,青梅市,本町,850,9,412,3,438,6,380
132050460,青梅市,仲町,425,9,207,4,218,5,197
132050470,青梅市,上町,250,2,121,1,129,1,115
132050480,青梅市,森下町,416,1,206,1,210,0,160
132050490,青梅市,裏宿町,958,5,453,2,505,3,381
132050500,青梅市,天ヶ瀬町,1080,5,526,0,554,5,461
132050510,青梅市,滝ノ上町,632,4,308,0,324,4,297
132050520,青梅市,大柳町,1205,15,591,7,614,8,472
132050530,青梅市,新町,19452,295,10403,136,9049,159,8174
13205053001,青梅市,新町１丁目,2803,23,1498,14,1305,9,1160
13205053002,青梅市,新町２丁目,1748,29,946,11,802,18,721
13205053003,青梅市,新町３丁目,3273,55,1767,18,1506,37,1481
13205053004,青梅市,新町４丁目,1667,30,868,18,799,12,736
13205053005,青梅市,新町５丁目,2862,39,1496,20,1366,19,1107
13205053006,青梅市,新町６丁目,250,3,124,0,126,3,92
13205053007,青梅市,新町７丁目,3124,37,1681,23,1443,14,1240
13205053008,青梅市,新町８丁目,1239,26,630,8,609,18,482
13205053009,青梅市,新町９丁目,2486,53,1393,24,1093,29,1155
13206,府中市,,260274,4389,132172,2073,128102,2316,119569
132060010,府中市,多磨町,3868,144,1937,66,1931,78,1756
13206001001,府中市,多磨町１丁目,1880,63,933,31,947,32,891
13206001002,府中市,多磨町２丁目,1988,81,1004,35,984,46,865
13206001003,府中市,多磨町３丁目,0,0,0,0,0,0,0
13206001004,府中市,多磨町４丁目,0,0,0,0,0,0,0
132060020,府中市,朝日町,6411,418,3877,160,2534,258,4361
13206002001,府中市,朝日町１丁目,1807,39,870,18,937,21,752
13206002002,府中市,朝日町２丁目,1544,35,697,14,847,21,828
13206002003,府中市,朝日町３丁目,3060,344,2310,128,750,216,2781
132060030,府中市,紅葉丘,8387,150,4084,78,4303,72,3605
13206003001,府中市,紅葉丘１丁目,3039,33,1470,18,1569,15,1268
13206003002,府中市,紅葉丘２丁目,2486,73,1238,38,1248,35,1118
13206003003,府中市,紅葉丘３丁目,2862,44,1376,22,1486,22,1219
132060040,府中市,白糸台,18172,275,8907,95,9265,180,8612
13206004001,府中市,白糸台１丁目,4595,54,2228,25,2367,29,2024
13206004002,府中市,白糸台２丁目,2584,38,1311,14,1273,24,1317
13206004003,府中市,白糸台３丁目,3609,38,1755,12,1854,26,1518
13206004004,府中市,白糸台４丁目,2513,82,1225,22,1288,60,1405
13206004005,府中市,白糸台５丁目,2256,31,1113,11,1143,20,1139
13206004006,府中市,白糸台６丁目,2615,32,1275,11,1340,21,1209
132060050,府中市,押立町,9915,81,4829,26,5086,55,4099
13206005001,府中市,押立町１丁目,4360,32,2060,10,2300,22,1873
13206005002,府中市,押立町２丁目,1618,9,794,2,824,7,651
13206005003,府中市,押立町３丁目,1260,14,615,6,645,8,489
13206005004,府中市,押立町４丁目,1228,15,621,4,607,11,486
13206005005,府中市,押立町５丁目,1449,11,739,4,710,7,600
132060060,府中市,小柳町,8734,125,4467,63,4267,62,4048
13206006001,府中市,小柳町１丁目,937,17,468,9,469,8,522
13206006002,府中市,小柳町２丁目,2207,46,1162,27,1045,19,1141
13206006003,府中市,小柳町３丁目,1244,13,625,6,619,7,450
13206006004,府中市,小柳町４丁目,1651,29,861,14,790,15,772
13206006005,府中市,小柳町５丁目,2128,17,1068,7,1060,10,935
13206006006,府中市,小柳町６丁目,567,3,283,0,284,3,228
132060070,府中市,若松町,12755,166,6471,71,6284,95,5791
13206007001,府中市,若松町１丁目,3375,46,1672,17,1703,29,1769
13206007002,府中市,若松町２丁目,3702,53,1868,21,1834,32,1682
13206007003,府中市,若松町３丁目,2373,23,1200,8,1173,15,1011
13206007004,府中市,若松町４丁目,2707,37,1450,23,1257,14,1123
13206007005,府中市,若松町５丁目,598,7,281,2,317,5,206
132060080,府中市,浅間町,6861,60,3413,27,3448,33,2597
13206008001,府中市,浅間町１丁目,490,1,311,0,179,1,149
13206008002,府中市,浅間町２丁目,1147,24,567,11,580,13,527
13206008003,府中市,浅間町３丁目,3047,19,1482,9,1565,10,1080
13206008004,府中市,浅間町４丁目,2177,16,1053,7,1124,9,841
132060090,府中市,天神町,7563,116,3774,50,3789,66,3129
13206009001,府中市,天神町１丁目,3332,38,1643,15,1689,23,1267
13206009002,府中市,天神町２丁目,1639,30,819,12,820,18,750
13206009003,府中市,天神町３丁目,1205,21,619,7,586,14,543
13206009004,府中市,天神町４丁目,1387,27,693,16,694,11,569
132060100,府中市,新町,9489,126,4618,47,4871,79,4191
13206010001,府中市,新町１丁目,3731,65,1840,23,1891,42,1746
13206010002,府中市,新町２丁目,3654,28,1810,16,1844,12,1500
13206010003,府中市,新町３丁目,2104,33,968,8,1136,25,945
132060110,府中市,幸町,4038,160,1957,70,2081,90,1806
13206011001,府中市,幸町１丁目,1584,23,786,10,798,13,812
13206011002,府中市,幸町２丁目,1770,122,834,54,936,68,755
13206011003,府中市,幸町３丁目,684,15,337,6,347,9,239
132060120,府中市,府中町,6786,191,3443,80,3343,111,3785
13206012001,府中市,府中町１丁目,2390,51,1258,21,1132,30,1401
13206012002,府中市,府中町２丁目,2581,77,1259,27,1322,50,1501
13206012003,府中市,府中町３丁目,1815,63,926,32,889,31,883
132060130,府中市,緑町,7314,141,3652,54,3662,87,3679
13206013001,府中市,緑町１丁目,2850,50,1386,16,1464,34,1324
13206013002,府中市,緑町２丁目,2028,29,1061,16,967,13,1048
13206013003,府中市,緑町３丁目,2436,62,1205,22,1231,40,1307
132060140,府中市,宮町,5224,56,2521,12,2703,44,2656
13206014001,府中市,宮町１丁目,3415,35,1630,9,1785,26,1699
13206014002,府中市,宮町２丁目,1146,15,560,2,586,13,631
13206014003,府中市,宮町３丁目,663,6,331,1,332,5,326
132060150,府中市,八幡町,5706,102,2942,41,2764,61,2968
13206015001,府中市,八幡町１丁目,1738,33,854,17,884,16,854
13206015002,府中市,八幡町２丁目,2907,50,1542,19,1365,31,1540
13206015003,府中市,八幡町３丁目,1061,19,546,5,515,14,574
132060160,府中市,清水が丘,5961,64,3005,20,2956,44,3248
13206016001,府中市,清水が丘１丁目,1153,19,560,5,593,14,709
13206016002,府中市,清水が丘２丁目,2409,27,1217,7,1192,20,1249
13206016003,府中市,清水が丘３丁目,2399,18,1228,8,1171,10,1290
132060170,府中市,日吉町,0,0,0,0,0,0,0
132060180,府中市,是政,13357,116,6785,48,6572,68,5467
13206018001,府中市,是政１丁目,2405,33,1214,14,1191,19,1023
13206018002,府中市,是政２丁目,1636,16,856,9,780,7,743
13206018003,府中市,是政３丁目,2196,21,1143,8,1053,13,911
13206018004,府中市,是政４丁目,3358,28,1663,8,1695,20,1142
13206018005,府中市,是政５丁目,2909,16,1452,7,1457,9,1277
13206018006,府中市,是政６丁目,853,2,457,2,396,0,371
132060190,府中市,矢崎町,2967,33,1524,17,1443,16,1296
13206019001,府中市,矢崎町１丁目,989,5,504,1,485,4,448
13206019002,府中市,矢崎町２丁目,1090,17,565,10,525,7,485
13206019003,府中市,矢崎町３丁目,23,0,13,0,10,0,17
13206019004,府中市,矢崎町４丁目,668,7,327,2,341,5,260
13206019005,府中市,矢崎町５丁目,197,4,115,4,82,0,86
132060200,府中市,南町,8828,92,4314,37,4514,55,3875
13206020001,府中市,南町１丁目,1324,12,640,4,684,8,574
13206020002,府中市,南町２丁目,1401,8,715,5,686,3,539
13206020003,府中市,南町３丁目,1669,9,848,2,821,7,704
13206020004,府中市,南町４丁目,3194,59,1510,24,1684,35,1596
13206020005,府中市,南町５丁目,728,1,362,1,366,0,293
13206020006,府中市,南町６丁目,512,3,239,1,273,2,169
132060210,府中市,本町,6134,76,3104,31,3030,45,2809
13206021001,府中市,本町１丁目,1347,14,690,4,657,10,635
13206021002,府中市,本町２丁目,2765,38,1379,17,1386,21,1204
13206021003,府中市,本町３丁目,826,13,419,4,407,9,392
13206021004,府中市,本町４丁目,1196,11,616,6,580,5,578
132060220,府中市,片町,3007,43,1524,17,1483,26,1515
13206022001,府中市,片町１丁目,1685,21,841,10,844,11,859
13206022002,府中市,片町２丁目,927,20,466,7,461,13,449
13206022003,府中市,片町３丁目,395,2,217,0,178,2,207
132060230,府中市,宮西町,5270,120,2724,51,2546,69,2938
13206023001,府中市,宮西町１丁目,1622,15,781,6,841,9,702
13206023002,府中市,宮西町２丁目,570,13,299,6,271,7,378
13206023003,府中市,宮西町３丁目,1726,58,925,23,801,35,1042
13206023004,府中市,宮西町４丁目,381,18,202,10,179,8,236
13206023005,府中市,宮西町５丁目,971,16,517,6,454,10,580
132060240,府中市,寿町,2415,38,1151,16,1264,22,1345
13206024001,府中市,寿町１丁目,451,4,204,1,247,3,249
13206024002,府中市,寿町２丁目,1120,21,555,11,565,10,608
13206024003,府中市,寿町３丁目,844,13,392,4,452,9,488
132060250,府中市,日鋼町,1217,22,607,6,610,16,568
132060260,府中市,晴見町,9037,536,5620,486,3417,50,3278
13206026001,府中市,晴見町１丁目,3433,50,1672,24,1761,26,1569
13206026002,府中市,晴見町２丁目,1610,17,824,5,786,12,766
13206026003,府中市,晴見町３丁目,1129,17,612,7,517,10,625
13206026004,府中市,晴見町４丁目,2865,452,2512,450,353,2,318
132060270,府中市,栄町,5222,64,2608,25,2614,39,2505
13206027001,府中市,栄町１丁目,1698,14,832,4,866,10,865
13206027002,府中市,栄町２丁目,1427,21,703,9,724,12,696
13206027003,府中市,栄町３丁目,2097,29,1073,12,1024,17,944
132060280,府中市,武蔵台,7886,76,3793,30,4093,46,3497
13206028001,府中市,武蔵台１丁目,2504,23,1243,7,1261,16,1048
13206028002,府中市,武蔵台２丁目,2572,26,1147,10,1425,16,1030
13206028003,府中市,武蔵台３丁目,2810,27,1403,13,1407,14,1419
132060290,府中市,北山町,4144,67,1976,32,2168,35,1769
13206029001,府中市,北山町１丁目,639,4,293,0,346,4,278
13206029002,府中市,北山町２丁目,1577,23,755,12,822,11,696
13206029003,府中市,北山町３丁目,838,9,435,5,403,4,351
13206029004,府中市,北山町４丁目,1090,31,493,15,597,16,444
132060300,府中市,西原町,3683,29,1815,10,1868,19,1527
13206030001,府中市,西原町１丁目,130,10,63,4,67,6,68
13206030002,府中市,西原町２丁目,1267,9,617,4,650,5,495
13206030003,府中市,西原町３丁目,828,6,419,1,409,5,386
13206030004,府中市,西原町４丁目,1458,4,716,1,742,3,578
132060310,府中市,東芝町,2793,71,1601,39,1192,32,1281
132060320,府中市,美好町,9112,151,4696,62,4416,89,4614
13206032001,府中市,美好町１丁目,2020,44,955,17,1065,27,1051
13206032002,府中市,美好町２丁目,3225,54,1667,24,1558,30,1476
13206032003,府中市,美好町３丁目,3867,53,2074,21,1793,32,2087
132060330,府中市,分梅町,6471,75,3301,37,3170,38,2987
13206033001,府中市,分梅町１丁目,1282,8,662,3,620,5,669
13206033002,府中市,分梅町２丁目,1497,14,773,8,724,6,678
13206033003,府中市,分梅町３丁目,1313,26,686,16,627,10,585
13206033004,府中市,分梅町４丁目,795,7,396,5,399,2,332
13206033005,府中市,分梅町５丁目,1584,20,784,5,800,15,723
132060340,府中市,住吉町,12357,128,6157,48,6200,80,5757
13206034001,府中市,住吉町１丁目,2429,17,1169,7,1260,10,1145
13206034002,府中市,住吉町２丁目,4682,61,2307,22,2375,39,2108
13206034003,府中市,住吉町３丁目,2126,13,1141,4,985,9,985
13206034004,府中市,住吉町４丁目,1599,21,817,8,782,13,797
13206034005,府中市,住吉町５丁目,1521,16,723,7,798,9,722
132060350,府中市,四谷,12665,104,6386,45,6279,59,5060
13206035001,府中市,四谷１丁目,3364,23,1692,11,1672,12,1444
13206035002,府中市,四谷２丁目,1271,12,625,3,646,9,530
13206035003,府中市,四谷３丁目,3260,24,1602,10,1658,14,1323
13206035004,府中市,四谷４丁目,1439,21,765,11,674,10,614
13206035005,府中市,四谷５丁目,2362,14,1217,6,1145,8,822
13206035006,府中市,四谷６丁目,969,10,485,4,484,6,327
132060360,府中市,日新町,3557,26,1987,14,1570,12,1588
13206036001,府中市,日新町１丁目,426,6,336,3,90,3,338
13206036002,府中市,日新町２丁目,855,0,461,0,394,0,348
13206036003,府中市,日新町３丁目,741,13,406,7,335,6,330
13206036004,府中市,日新町４丁目,447,1,232,1,215,0,167
13206036005,府中市,日新町５丁目,1088,6,552,3,536,3,405
132060370,府中市,本宿町,6512,72,3293,22,3219,50,2840
13206037001,府中市,本宿町１丁目,1655,22,837,6,818,16,773
13206037002,府中市,本宿町２丁目,1647,26,866,7,781,19,791
13206037003,府中市,本宿町３丁目,1653,17,825,7,828,10,653
13206037004,府中市,本宿町４丁目,1557,7,765,2,792,5,623
132060380,府中市,西府町,6456,75,3309,40,3147,35,2722
13206038001,府中市,西府町１丁目,1586,13,810,4,776,9,631
13206038002,府中市,西府町２丁目,1617,14,844,5,773,9,721
13206038003,府中市,西府町３丁目,1714,10,857,4,857,6,696
13206038004,府中市,西府町４丁目,975,25,503,23,472,2,407
13206038005,府中市,西府町５丁目,564,13,295,4,269,9,267
13207,昭島市,,111539,1967,55394,878,56145,1089,48258
132070010,昭島市,東町,4068,122,1990,50,2078,72,1777
13207001001,昭島市,東町１丁目,1485,13,709,7,776,6,635
13207001002,昭島市,東町２丁目,385,7,189,3,196,4,157
13207001003,昭島市,東町３丁目,650,10,332,3,318,7,292
13207001004,昭島市,東町４丁目,1132,88,554,35,578,53,500
13207001005,昭島市,東町５丁目,416,4,206,2,210,2,193
132070020,昭島市,郷地町,3500,34,1744,14,1756,20,1435
13207002001,昭島市,郷地町１丁目,924,8,467,5,457,3,381
13207002002,昭島市,郷地町２丁目,1380,7,659,2,721,5,531
13207002003,昭島市,郷地町３丁目,1196,19,618,7,578,12,523
132070030,昭島市,武蔵野,4625,81,2312,29,2313,52,1836
13207003002,昭島市,武蔵野２丁目,2088,44,1078,19,1010,25,869
13207003003,昭島市,武蔵野３丁目,2537,37,1234,10,1303,27,967
132070040,昭島市,玉川町,7750,162,3789,76,3961,86,3910
13207004001,昭島市,玉川町１丁目,1875,68,842,31,1033,37,1135
13207004002,昭島市,玉川町２丁目,785,13,399,7,386,6,437
13207004003,昭島市,玉川町３丁目,1987,40,1005,21,982,19,923
13207004004,昭島市,玉川町４丁目,1137,25,562,13,575,12,495
13207004005,昭島市,玉川町５丁目,1966,16,981,4,985,12,920
132070051,昭島市,福島町,4127,61,2089,27,2038,34,1650
13207005101,昭島市,福島町１丁目,1077,15,548,5,529,10,427
13207005102,昭島市,福島町２丁目,1674,22,822,11,852,11,667
13207005103,昭島市,福島町３丁目,1376,24,719,11,657,13,556
132070052,昭島市,福島町,1133,47,544,23,589,24,662
132070070,昭島市,朝日町,5810,76,2901,31,2909,45,2657
13207007001,昭島市,朝日町１丁目,924,16,479,5,445,11,481
13207007002,昭島市,朝日町２丁目,834,9,438,6,396,3,405
13207007003,昭島市,朝日町３丁目,1055,3,531,1,524,2,513
13207007004,昭島市,朝日町４丁目,1746,37,832,17,914,20,732
13207007005,昭島市,朝日町５丁目,1251,11,621,2,630,9,526
132070080,昭島市,つつじが丘,5740,99,2774,44,2966,55,2529
13207008001,昭島市,つつじが丘１丁目,0,0,0,0,0,0,0
13207008002,昭島市,つつじが丘２丁目,3211,17,1546,7,1665,10,1344
13207008003,昭島市,つつじが丘３丁目,2529,82,1228,37,1301,45,1185
132070090,昭島市,美堀町,7313,164,3594,88,3719,76,3160
13207009001,昭島市,美堀町１丁目,1492,24,721,12,771,12,555
13207009002,昭島市,美堀町２丁目,1907,21,905,9,1002,12,752
13207009003,昭島市,美堀町３丁目,417,20,214,13,203,7,165
13207009004,昭島市,美堀町４丁目,750,28,389,21,361,7,387
13207009005,昭島市,美堀町５丁目,2747,71,1365,33,1382,38,1301
132070100,昭島市,昭和町,4750,66,2295,27,2455,39,2365
13207010001,昭島市,昭和町１丁目,1060,4,517,1,543,3,500
13207010002,昭島市,昭和町２丁目,914,18,448,8,466,10,496
13207010003,昭島市,昭和町３丁目,1106,5,528,2,578,3,471
13207010004,昭島市,昭和町４丁目,600,8,289,4,311,4,288
13207010005,昭島市,昭和町５丁目,1070,31,513,12,557,19,610
132070111,昭島市,大神町,4386,56,2266,23,2120,33,1709
13207011101,昭島市,大神町１丁目,947,7,491,3,456,4,406
13207011102,昭島市,大神町２丁目,818,5,417,4,401,1,322
13207011103,昭島市,大神町３丁目,1073,11,543,2,530,9,448
13207011104,昭島市,大神町４丁目,1548,33,815,14,733,19,533
132070112,昭島市,大神町,0,0,0,0,0,0,0
132070130,昭島市,松原町,9015,231,4442,103,4573,128,3939
13207013001,昭島市,松原町１丁目,4193,90,2014,37,2179,53,1800
13207013002,昭島市,松原町２丁目,1188,25,614,11,574,14,518
13207013003,昭島市,松原町３丁目,1494,24,731,9,763,15,574
13207013004,昭島市,松原町４丁目,819,43,413,14,406,29,406
13207013005,昭島市,松原町５丁目,1321,49,670,32,651,17,641
132070141,昭島市,田中町,7064,117,3538,55,3526,62,2834
13207014101,昭島市,田中町１丁目,2671,24,1361,10,1310,14,1132
13207014102,昭島市,田中町２丁目,1874,15,896,7,978,8,583
13207014103,昭島市,田中町３丁目,2400,76,1213,38,1187,38,1069
13207014104,昭島市,田中町４丁目,119,2,68,0,51,2,50
132070142,昭島市,田中町,0,0,0,0,0,0,0
132070160,昭島市,緑町,10823,147,5624,70,5199,77,4665
13207016001,昭島市,緑町１丁目,2152,25,1091,12,1061,13,914
13207016002,昭島市,緑町２丁目,2179,17,1121,6,1058,11,920
13207016003,昭島市,緑町３丁目,2371,25,1217,9,1154,16,938
13207016004,昭島市,緑町４丁目,2689,54,1400,28,1289,26,1217
13207016005,昭島市,緑町５丁目,1432,26,795,15,637,11,676
132070171,昭島市,拝島町,7094,205,3475,81,3619,124,3144
13207017101,昭島市,拝島町１丁目,907,11,469,7,438,4,408
13207017102,昭島市,拝島町２丁目,1543,41,825,17,718,24,676
13207017103,昭島市,拝島町３丁目,3002,122,1333,42,1669,80,1411
13207017104,昭島市,拝島町４丁目,1222,20,625,10,597,10,482
13207017105,昭島市,拝島町５丁目,420,11,223,5,197,6,167
13207017106,昭島市,拝島町６丁目,0,0,0,0,0,0,0
132070172,昭島市,拝島町,138,1,33,1,105,0,10
132070190,昭島市,築地町,421,1,225,0,196,1,154
132070201,昭島市,中神町,3739,40,1854,22,1885,18,1401
13207020101,昭島市,中神町１丁目,1678,20,831,12,847,8,649
13207020102,昭島市,中神町２丁目,1902,20,943,10,959,10,698
13207020103,昭島市,中神町３丁目,159,0,80,0,79,0,54
132070202,昭島市,中神町,9074,178,4318,82,4756,96,3881
13207020290,昭島市,中神町,5920,125,2852,59,3068,66,2573
13207020291,昭島市,中神町,3154,53,1466,23,1688,30,1308
132070211,昭島市,宮沢町,4598,35,2375,16,2223,19,1829
13207021101,昭島市,宮沢町１丁目,1356,19,696,7,660,12,534
13207021102,昭島市,宮沢町２丁目,2656,15,1367,8,1289,7,1051
13207021103,昭島市,宮沢町３丁目,586,1,312,1,274,0,244
132070212,昭島市,宮沢町,3359,20,1684,7,1675,13,1311
132070221,昭島市,上川原町,3012,24,1528,9,1484,15,1400
13207022101,昭島市,上川原町１丁目,932,8,470,4,462,4,408
13207022102,昭島市,上川原町２丁目,1189,10,600,3,589,7,592
13207022103,昭島市,上川原町３丁目,891,6,458,2,433,4,400
132070222,昭島市,上川原町,0,0,0,0,0,0,0
13208,調布市,,229061,2960,111921,1397,117140,1563,110581
132080010,調布市,飛田給,7974,116,4041,54,3933,62,4232
13208001001,調布市,飛田給１丁目,3101,53,1536,29,1565,24,1700
13208001002,調布市,飛田給２丁目,2846,40,1456,18,1390,22,1659
13208001003,調布市,飛田給３丁目,2027,23,1049,7,978,16,873
132080020,調布市,上石原,11121,145,5676,74,5445,71,5174
13208002001,調布市,上石原１丁目,3307,50,1768,32,1539,18,1922
13208002002,調布市,上石原２丁目,2222,22,1129,6,1093,16,1147
13208002003,調布市,上石原３丁目,5592,73,2779,36,2813,37,2105
132080030,調布市,富士見町,8964,145,4580,73,4384,72,4121
13208003001,調布市,富士見町１丁目,1359,16,692,9,667,7,680
13208003002,調布市,富士見町２丁目,2778,81,1432,44,1346,37,1311
13208003003,調布市,富士見町３丁目,2722,34,1373,11,1349,23,1167
13208003004,調布市,富士見町４丁目,2105,14,1083,9,1022,5,963
132080040,調布市,下石原,8432,121,4225,66,4207,55,4190
13208004001,調布市,下石原１丁目,2460,59,1264,29,1196,30,1317
13208004002,調布市,下石原２丁目,2233,19,1122,12,1111,7,1162
13208004003,調布市,下石原３丁目,3739,43,1839,25,1900,18,1711
132080050,調布市,小島町,9543,135,4663,61,4880,74,5217
13208005001,調布市,小島町１丁目,2081,19,996,5,1085,14,1136
13208005002,調布市,小島町２丁目,3013,44,1474,21,1539,23,1750
13208005003,調布市,小島町３丁目,4449,72,2193,35,2256,37,2331
132080060,調布市,布田,14144,221,6889,103,7255,118,7820
13208006001,調布市,布田１丁目,2274,31,1066,11,1208,20,1300
13208006002,調布市,布田２丁目,3145,62,1550,31,1595,31,1917
13208006003,調布市,布田３丁目,1927,24,931,13,996,11,1035
13208006004,調布市,布田４丁目,2668,54,1265,24,1403,30,1552
13208006005,調布市,布田５丁目,2253,27,1144,13,1109,14,1206
13208006006,調布市,布田６丁目,1877,23,933,11,944,12,810
132080070,調布市,下布田,0,0,0,0,0,0,0
132080080,調布市,国領町,26276,418,12483,194,13793,224,13171
13208008001,調布市,国領町１丁目,4001,71,1888,27,2113,44,2264
13208008002,調布市,国領町２丁目,1915,21,965,7,950,14,950
13208008003,調布市,国領町３丁目,3845,70,1652,30,2193,40,1910
13208008004,調布市,国領町４丁目,3334,49,1636,24,1698,25,1775
13208008005,調布市,国領町５丁目,3719,59,1893,34,1826,25,2020
13208008006,調布市,国領町６丁目,1155,10,577,5,578,5,567
13208008007,調布市,国領町７丁目,3297,40,1701,22,1596,18,1661
13208008008,調布市,国領町８丁目,5010,98,2171,45,2839,53,2024
132080090,調布市,染地,14806,124,7065,55,7741,69,6208
13208009001,調布市,染地１丁目,1928,16,911,5,1017,11,777
13208009002,調布市,染地２丁目,6384,46,3067,21,3317,25,2396
13208009003,調布市,染地３丁目,6494,62,3087,29,3407,33,3035
132080100,調布市,多摩川,15553,320,8060,179,7493,141,7330
13208010001,調布市,多摩川１丁目,4109,46,2128,24,1981,22,1654
13208010002,調布市,多摩川２丁目,784,45,421,23,363,22,385
13208010003,調布市,多摩川３丁目,4358,135,2278,86,2080,49,1938
13208010004,調布市,多摩川４丁目,885,19,472,12,413,7,495
13208010005,調布市,多摩川５丁目,3063,47,1557,19,1506,28,1762
13208010006,調布市,多摩川６丁目,1030,9,537,4,493,5,453
13208010007,調布市,多摩川７丁目,1324,19,667,11,657,8,643
132080110,調布市,佐須町,5911,66,2919,24,2992,42,2496
13208011001,調布市,佐須町１丁目,872,9,413,3,459,6,305
13208011002,調布市,佐須町２丁目,1321,21,664,6,657,15,545
13208011003,調布市,佐須町３丁目,1251,10,613,5,638,5,546
13208011004,調布市,佐須町４丁目,1909,17,953,9,956,8,819
13208011005,調布市,佐須町５丁目,558,9,276,1,282,8,281
132080120,調布市,柴崎,8148,73,3931,37,4217,36,3594
13208012001,調布市,柴崎１丁目,3464,45,1685,28,1779,17,1629
13208012002,調布市,柴崎２丁目,4684,28,2246,9,2438,19,1965
132080130,調布市,菊野台,9152,72,4513,34,4639,38,4969
13208013001,調布市,菊野台１丁目,2350,16,1140,6,1210,10,1286
13208013002,調布市,菊野台２丁目,2975,23,1454,11,1521,12,1718
13208013003,調布市,菊野台３丁目,3827,33,1919,17,1908,16,1965
132080140,調布市,東つつじケ丘,5531,41,2752,18,2779,23,2902
13208014001,調布市,東つつじケ丘１丁目,955,8,504,3,451,5,665
13208014002,調布市,東つつじケ丘２丁目,2605,21,1233,8,1372,13,1275
13208014003,調布市,東つつじケ丘３丁目,1971,12,1015,7,956,5,962
132080150,調布市,西つつじケ丘,14081,207,6725,101,7356,106,7381
13208015001,調布市,西つつじケ丘１丁目,4560,57,2243,27,2317,30,2258
13208015002,調布市,西つつじケ丘２丁目,1642,11,750,8,892,3,743
13208015003,調布市,西つつじケ丘３丁目,2396,30,1102,11,1294,19,1498
13208015004,調布市,西つつじケ丘４丁目,5483,109,2630,55,2853,54,2882
132080160,調布市,入間町,7388,70,3570,31,3818,39,3284
13208016001,調布市,入間町１丁目,3248,34,1573,15,1675,19,1483
13208016002,調布市,入間町２丁目,2615,24,1267,12,1348,12,1108
13208016003,調布市,入間町３丁目,1525,12,730,4,795,8,693
132080170,調布市,仙川町,7360,86,3258,41,4102,45,4349
13208017001,調布市,仙川町１丁目,3050,43,1336,20,1714,23,1946
13208017002,調布市,仙川町２丁目,2682,28,1204,12,1478,16,1548
13208017003,調布市,仙川町３丁目,1628,15,718,9,910,6,855
132080180,調布市,緑ケ丘,6785,64,3111,25,3674,39,3209
13208018001,調布市,緑ケ丘１丁目,2329,22,1104,10,1225,12,1140
13208018002,調布市,緑ケ丘２丁目,4456,42,2007,15,2449,27,2069
132080190,調布市,野水,96,6,48,1,48,5,36
13208019001,調布市,野水１丁目,96,6,48,1,48,5,36
13208019002,調布市,野水２丁目,0,0,0,0,0,0,0
132080200,調布市,西町,239,0,104,0,135,0,7
132080210,調布市,若葉町,6080,89,2907,34,3173,55,3094
13208021001,調布市,若葉町１丁目,2554,53,1195,8,1359,45,1297
13208021002,調布市,若葉町２丁目,2317,11,1084,6,1233,5,1242
13208021003,調布市,若葉町３丁目,1209,25,628,20,581,5,555
132080220,調布市,調布ケ丘,9924,160,4891,70,5033,90,4686
13208022001,調布市,調布ケ丘１丁目,1881,60,916,23,965,37,926
13208022002,調布市,調布ケ丘２丁目,1741,31,911,17,830,14,1004
13208022003,調布市,調布ケ丘３丁目,4858,43,2344,19,2514,24,2075
13208022004,調布市,調布ケ丘４丁目,1444,26,720,11,724,15,681
132080230,調布市,深大寺元町,4577,42,2267,21,2310,21,1991
13208023001,調布市,深大寺元町１丁目,1232,13,632,8,600,5,589
13208023002,調布市,深大寺元町２丁目,692,5,331,3,361,2,286
13208023003,調布市,深大寺元町３丁目,1048,8,504,4,544,4,423
13208023004,調布市,深大寺元町４丁目,1246,9,606,2,640,7,531
13208023005,調布市,深大寺元町５丁目,359,7,194,4,165,3,162
132080240,調布市,深大寺北町,7287,56,3574,25,3713,31,2870
13208024001,調布市,深大寺北町１丁目,868,4,423,0,445,4,383
13208024002,調布市,深大寺北町２丁目,627,7,325,4,302,3,256
13208024003,調布市,深大寺北町３丁目,619,4,304,2,315,2,234
13208024004,調布市,深大寺北町４丁目,1272,7,618,3,654,4,373
13208024005,調布市,深大寺北町５丁目,938,6,458,2,480,4,393
13208024006,調布市,深大寺北町６丁目,2015,16,968,7,1047,9,831
13208024007,調布市,深大寺北町７丁目,948,12,478,7,470,5,400
132080250,調布市,深大寺東町,11434,109,5622,46,5812,63,4692
13208025001,調布市,深大寺東町１丁目,1304,13,687,4,617,9,524
13208025002,調布市,深大寺東町２丁目,938,4,471,1,467,3,360
13208025003,調布市,深大寺東町３丁目,1421,20,697,10,724,10,545
13208025004,調布市,深大寺東町４丁目,1451,16,713,8,738,8,573
13208025005,調布市,深大寺東町５丁目,1318,24,676,12,642,12,541
13208025006,調布市,深大寺東町６丁目,1847,13,873,3,974,10,801
13208025007,調布市,深大寺東町７丁目,1688,13,819,5,869,8,706
13208025008,調布市,深大寺東町８丁目,1467,6,686,3,781,3,642
132080260,調布市,深大寺南町,5226,36,2551,17,2675,19,2001
13208026001,調布市,深大寺南町１丁目,559,4,269,2,290,2,214
13208026002,調布市,深大寺南町２丁目,582,2,300,0,282,2,214
13208026003,調布市,深大寺南町３丁目,2093,15,1024,7,1069,8,707
13208026004,調布市,深大寺南町４丁目,675,8,344,5,331,3,300
13208026005,調布市,深大寺南町５丁目,1317,7,614,3,703,4,566
132080270,調布市,八雲台,3029,38,1496,13,1533,25,1557
13208027001,調布市,八雲台１丁目,1989,23,971,8,1018,15,985
13208027002,調布市,八雲台２丁目,1040,15,525,5,515,10,572
13209,町田市,,432348,4727,212312,2169,220036,2558,186711
132090010,町田市,相原町,16008,157,7891,59,8117,98,6717
13209001081,町田市,相原町,1895,48,818,15,1077,33,925
13209001090,町田市,相原町,13254,89,6618,31,6636,58,5433
13209001091,町田市,相原町,859,20,455,13,404,7,359
132090020,町田市,旭町,4909,33,2515,14,2394,19,2432
13209002001,町田市,旭町１丁目,1742,20,900,12,842,8,952
13209002002,町田市,旭町２丁目,1058,6,546,1,512,5,531
13209002003,町田市,旭町３丁目,2109,7,1069,1,1040,6,949
132090030,町田市,大蔵町,9209,110,4618,51,4591,59,3922
132090040,町田市,小川,5238,73,2636,38,2602,35,1985
132090041,町田市,小川,7703,52,3783,28,3920,24,3177
13209004101,町田市,小川１丁目,2748,26,1354,14,1394,12,1084
13209004102,町田市,小川２丁目,2611,10,1277,6,1334,4,1076
13209004103,町田市,小川３丁目,1063,10,526,5,537,5,456
13209004104,町田市,小川４丁目,1281,6,626,3,655,3,561
132090050,町田市,小野路町,4290,47,2146,24,2144,23,1711
132090061,町田市,小山田桜台,3736,32,1816,12,1920,20,1501
13209006101,町田市,小山田桜台１丁目,1755,14,861,5,894,9,711
13209006102,町田市,小山田桜台２丁目,1981,18,955,7,1026,11,790
132090070,町田市,小山町,17990,187,9135,93,8855,94,7108
13209007000,町田市,小山町,15907,171,8068,82,7839,89,6346
13209007091,町田市,小山町,2083,16,1067,11,1016,5,762
132090081,町田市,金井,8466,47,4165,19,4301,28,3159
13209008101,町田市,金井１丁目,1689,8,829,3,860,5,644
13209008104,町田市,金井４丁目,960,8,465,4,495,4,381
13209008105,町田市,金井５丁目,1655,11,825,6,830,5,584
13209008106,町田市,金井６丁目,1745,9,861,3,884,6,660
13209008107,町田市,金井７丁目,970,5,459,2,511,3,333
13209008108,町田市,金井８丁目,1447,6,726,1,721,5,557
132090082,町田市,金井,2653,8,1290,4,1363,4,1022
13209008202,町田市,金井２丁目,1307,7,659,4,648,3,502
13209008203,町田市,金井３丁目,1346,1,631,0,715,1,520
132090083,町田市,金井町,8295,60,4157,31,4138,29,3641
13209008300,町田市,金井町,7091,42,3572,23,3519,19,2963
13209008382,町田市,金井町,1204,18,585,8,619,10,678
132090090,町田市,金森,14748,217,7125,98,7623,119,6325
13209009001,町田市,金森１丁目,2940,44,1439,19,1501,25,1405
13209009002,町田市,金森２丁目,3182,47,1538,27,1644,20,1294
13209009003,町田市,金森３丁目,1726,10,864,3,862,7,711
13209009004,町田市,金森４丁目,2236,25,1067,10,1169,15,971
13209009005,町田市,金森５丁目,607,5,313,2,294,3,266
13209009006,町田市,金森６丁目,1976,21,969,8,1007,13,727
13209009007,町田市,金森７丁目,2081,65,935,29,1146,36,951
132090100,町田市,上小山田町,4998,40,2537,24,2461,16,1592
132090111,町田市,木曽東,15300,235,7447,114,7853,121,7983
13209011101,町田市,木曽東１丁目,4485,49,2065,18,2420,31,2000
13209011102,町田市,木曽東２丁目,2475,81,1259,49,1216,32,1515
13209011103,町田市,木曽東３丁目,3403,42,1680,18,1723,24,1616
13209011104,町田市,木曽東４丁目,4937,63,2443,29,2494,34,2852
132090112,町田市,木曽西,5560,58,2716,28,2844,30,2217
13209011201,町田市,木曽西１丁目,1912,21,932,8,980,13,807
13209011204,町田市,木曽西４丁目,1727,20,847,11,880,9,671
13209011205,町田市,木曽西５丁目,1921,17,937,9,984,8,739
132090113,町田市,木曽町,359,5,173,1,186,4,144
13209011390,町田市,木曽町,254,5,116,1,138,4,104
13209011391,町田市,木曽町,105,0,57,0,48,0,40
132090114,町田市,木曽西,2233,12,1094,7,1139,5,818
13209011402,町田市,木曽西２丁目,851,8,430,6,421,2,319
13209011403,町田市,木曽西３丁目,1382,4,664,1,718,3,499
132090120,町田市,高ヶ坂,10460,106,5181,51,5279,55,4563
13209012001,町田市,高ヶ坂１丁目,353,9,171,3,182,6,162
13209012002,町田市,高ヶ坂２丁目,1513,22,774,13,739,9,665
13209012003,町田市,高ヶ坂３丁目,2561,32,1288,16,1273,16,1355
13209012004,町田市,高ヶ坂４丁目,1241,2,595,2,646,0,464
13209012005,町田市,高ヶ坂５丁目,1335,8,639,4,696,4,497
13209012006,町田市,高ヶ坂６丁目,1033,5,533,2,500,3,384
13209012007,町田市,高ヶ坂７丁目,2424,28,1181,11,1243,17,1036
132090130,町田市,下小山田町,3995,26,1924,18,2071,8,1432
132090141,町田市,真光寺,5484,48,2680,19,2804,29,2153
13209014101,町田市,真光寺１丁目,2211,13,1096,7,1115,6,825
13209014102,町田市,真光寺２丁目,1462,7,708,3,754,4,555
13209014103,町田市,真光寺３丁目,1811,28,876,9,935,19,773
132090142,町田市,真光寺町,2120,14,1045,9,1075,5,634
132090150,町田市,図師町,8497,55,4325,22,4172,33,3030
132090161,町田市,忠生,7336,100,3644,40,3692,60,3377
13209016101,町田市,忠生１丁目,1539,25,741,12,798,13,710
13209016102,町田市,忠生２丁目,2490,12,1248,3,1242,9,1093
13209016103,町田市,忠生３丁目,2105,31,1057,11,1048,20,967
13209016104,町田市,忠生４丁目,1202,32,598,14,604,18,607
132090170,町田市,玉川学園,17017,161,8079,76,8938,85,8224
13209017001,町田市,玉川学園１丁目,2173,12,1047,5,1126,7,1026
13209017002,町田市,玉川学園２丁目,1803,21,816,11,987,10,1006
13209017003,町田市,玉川学園３丁目,2283,10,1056,3,1227,7,1028
13209017004,町田市,玉川学園４丁目,2007,21,967,16,1040,5,894
13209017005,町田市,玉川学園５丁目,2740,42,1339,21,1401,21,1361
13209017006,町田市,玉川学園６丁目,405,0,182,0,223,0,183
13209017007,町田市,玉川学園７丁目,2846,24,1357,9,1489,15,1364
13209017008,町田市,玉川学園８丁目,2760,31,1315,11,1445,20,1362
132090181,町田市,つくし野,6533,76,3100,39,3433,37,2588
13209018101,町田市,つくし野１丁目,1860,21,884,10,976,11,752
13209018102,町田市,つくし野２丁目,1698,12,806,7,892,5,660
13209018103,町田市,つくし野３丁目,1495,38,707,20,788,18,583
13209018104,町田市,つくし野４丁目,1480,5,703,2,777,3,593
132090190,町田市,鶴川,12844,146,6267,67,6577,79,6235
13209019001,町田市,鶴川１丁目,1318,21,678,9,640,12,652
13209019002,町田市,鶴川２丁目,2480,33,1215,16,1265,17,1194
13209019003,町田市,鶴川３丁目,1523,15,798,6,725,9,715
13209019004,町田市,鶴川４丁目,2437,38,1167,19,1270,19,1051
13209019005,町田市,鶴川５丁目,3048,19,1457,9,1591,10,1615
13209019006,町田市,鶴川６丁目,2038,20,952,8,1086,12,1008
132090200,町田市,鶴間,16878,206,8179,102,8699,104,6597
132090201,町田市,鶴間,2182,24,1027,9,1155,15,944
13209020101,町田市,鶴間１丁目,1040,12,499,6,541,6,449
13209020102,町田市,鶴間２丁目,378,2,182,0,196,2,159
13209020103,町田市,鶴間３丁目,764,10,346,3,418,7,336
132090210,町田市,常盤町,4875,41,2481,17,2394,24,1955
132090220,町田市,中町,10146,172,5002,84,5144,88,5497
13209022001,町田市,中町１丁目,2758,42,1351,18,1407,24,1438
13209022002,町田市,中町２丁目,2149,45,1147,22,1002,23,1308
13209022003,町田市,中町３丁目,3009,58,1411,33,1598,25,1601
13209022004,町田市,中町４丁目,2230,27,1093,11,1137,16,1150
132090231,町田市,成瀬,5654,51,2692,20,2962,31,2426
13209023104,町田市,成瀬４丁目,644,5,346,1,298,4,261
13209023105,町田市,成瀬５丁目,786,4,392,1,394,3,297
13209023106,町田市,成瀬６丁目,1390,12,671,5,719,7,569
13209023107,町田市,成瀬７丁目,1606,25,688,11,918,14,810
13209023108,町田市,成瀬８丁目,1228,5,595,2,633,3,489
132090232,町田市,成瀬,3983,33,1999,15,1984,18,1506
13209023201,町田市,成瀬１丁目,1769,17,881,6,888,11,662
13209023202,町田市,成瀬２丁目,1569,11,795,7,774,4,635
13209023203,町田市,成瀬３丁目,645,5,323,2,322,3,209
132090241,町田市,成瀬が丘,4739,62,2346,28,2393,34,2283
13209024101,町田市,成瀬が丘１丁目,1300,22,653,9,647,13,627
13209024102,町田市,成瀬が丘２丁目,1346,13,655,5,691,8,701
13209024103,町田市,成瀬が丘３丁目,2093,27,1038,14,1055,13,955
132090251,町田市,成瀬台,7800,45,3781,26,4019,19,3125
13209025101,町田市,成瀬台１丁目,1759,8,881,4,878,4,682
13209025102,町田市,成瀬台２丁目,2418,12,1196,8,1222,4,956
13209025103,町田市,成瀬台３丁目,1859,17,869,9,990,8,770
13209025104,町田市,成瀬台４丁目,1764,8,835,5,929,3,717
132090261,町田市,根岸,2101,11,1048,2,1053,9,859
13209026101,町田市,根岸１丁目,688,5,351,1,337,4,274
13209026102,町田市,根岸２丁目,1413,6,697,1,716,5,585
132090262,町田市,根岸町,754,12,375,5,379,7,305
132090270,町田市,能ケ谷,11137,112,5409,44,5728,68,4791
13209027001,町田市,能ケ谷１丁目,1132,20,528,7,604,13,718
13209027002,町田市,能ケ谷２丁目,1521,39,736,13,785,26,785
13209027003,町田市,能ケ谷３丁目,949,15,484,10,465,5,426
13209027004,町田市,能ケ谷４丁目,1649,13,808,4,841,9,676
13209027005,町田市,能ケ谷５丁目,1825,10,878,5,947,5,673
13209027006,町田市,能ケ谷６丁目,1767,5,873,1,894,4,629
13209027007,町田市,能ケ谷７丁目,2294,10,1102,4,1192,6,884
132090280,町田市,野津田町,9936,75,4894,34,5042,41,3564
132090290,町田市,原町田,14760,396,7360,183,7400,213,8850
13209029001,町田市,原町田１丁目,3177,85,1566,39,1611,46,1830
13209029002,町田市,原町田２丁目,4718,166,2390,72,2328,94,2894
13209029003,町田市,原町田３丁目,1037,20,535,7,502,13,637
13209029004,町田市,原町田４丁目,2920,70,1413,34,1507,36,1548
13209029005,町田市,原町田５丁目,2302,36,1150,21,1152,15,1490
13209029006,町田市,原町田６丁目,606,19,306,10,300,9,451
132090300,町田市,東玉川学園,3272,14,1598,7,1674,7,1326
13209030001,町田市,東玉川学園１丁目,1461,8,719,2,742,6,632
13209030002,町田市,東玉川学園２丁目,1069,4,533,3,536,1,421
13209030003,町田市,東玉川学園３丁目,112,0,23,0,89,0,20
13209030004,町田市,東玉川学園４丁目,630,2,323,2,307,0,253
132090311,町田市,広袴,3471,32,1786,10,1685,22,1141
13209031101,町田市,広袴１丁目,235,15,212,4,23,11,7
13209031102,町田市,広袴２丁目,1194,6,553,2,641,4,454
13209031103,町田市,広袴３丁目,1877,11,942,4,935,7,628
13209031104,町田市,広袴４丁目,165,0,79,0,86,0,52
132090312,町田市,広袴町,1032,16,501,8,531,8,414
132090320,町田市,本町田,25477,198,12437,76,13040,122,11752
13209032081,町田市,本町田,5177,50,2532,15,2645,35,2871
13209032082,町田市,本町田,4196,36,2010,15,2186,21,2230
13209032083,町田市,本町田,1264,20,625,11,639,9,744
13209032090,町田市,本町田,6907,36,3361,16,3546,20,2753
13209032091,町田市,本町田,7933,56,3909,19,4024,37,3154
132090330,町田市,南大谷,10632,145,5280,67,5352,78,4361
13209033000,町田市,南大谷,10468,141,5194,65,5274,76,4241
13209033083,町田市,南大谷,164,4,86,2,78,2,120
132090341,町田市,南つくし野,5776,113,2801,56,2975,57,2329
13209034101,町田市,南つくし野１丁目,1034,19,493,6,541,13,401
13209034102,町田市,南つくし野２丁目,2011,25,947,9,1064,16,777
13209034103,町田市,南つくし野３丁目,1502,59,768,37,734,22,675
13209034104,町田市,南つくし野４丁目,1229,10,593,4,636,6,476
132090351,町田市,南成瀬,10676,135,5321,63,5355,72,4804
13209035101,町田市,南成瀬１丁目,2856,46,1366,20,1490,26,1212
13209035102,町田市,南成瀬２丁目,1423,25,715,11,708,14,594
13209035103,町田市,南成瀬３丁目,1081,3,555,0,526,3,502
13209035104,町田市,南成瀬４丁目,1054,11,524,5,530,6,522
13209035105,町田市,南成瀬５丁目,1878,18,943,10,935,8,875
13209035106,町田市,南成瀬６丁目,1263,19,632,9,631,10,595
13209035107,町田市,南成瀬７丁目,733,7,379,4,354,3,350
13209035108,町田市,南成瀬８丁目,388,6,207,4,181,2,154
132090360,町田市,三輪町,7014,74,3722,39,3292,35,3195
132090371,町田市,三輪緑山,5236,27,2495,11,2741,16,2027
13209037101,町田市,三輪緑山１丁目,1665,8,808,5,857,3,731
13209037102,町田市,三輪緑山２丁目,1395,14,622,3,773,11,485
13209037103,町田市,三輪緑山３丁目,1201,1,574,0,627,1,468
13209037104,町田市,三輪緑山４丁目,975,4,491,3,484,1,343
132090380,町田市,森野,13248,235,6270,104,6978,131,6654
13209038001,町田市,森野１丁目,2557,58,1192,22,1365,36,1443
13209038002,町田市,森野２丁目,3175,87,1495,38,1680,49,1839
13209038003,町田市,森野３丁目,1565,9,773,4,792,5,724
13209038004,町田市,森野４丁目,2277,39,1036,21,1241,18,941
13209038005,町田市,森野５丁目,2190,25,1040,11,1150,14,1054
13209038006,町田市,森野６丁目,1484,17,734,8,750,9,653
132090391,町田市,薬師台,2922,12,1398,2,1524,10,978
13209039101,町田市,薬師台１丁目,663,7,321,1,342,6,258
13209039102,町田市,薬師台２丁目,1079,3,538,1,541,2,356
13209039103,町田市,薬師台３丁目,1180,2,539,0,641,2,364
132090400,町田市,矢部町,1689,15,841,8,848,7,643
13209040000,町田市,矢部町,1145,9,554,5,591,4,430
13209040090,町田市,矢部町,544,6,287,3,257,3,213
132090411,町田市,山崎,827,3,397,0,430,3,375
132090412,町田市,山崎町,16073,136,7721,54,8352,82,7090
13209041281,町田市,山崎町,6828,79,3220,31,3608,48,3605
13209041282,町田市,山崎町,1205,16,524,7,681,9,524
13209041290,町田市,山崎町,6604,32,3252,12,3352,20,2491
13209041291,町田市,山崎町,1436,9,725,4,711,5,470
132090420,町田市,小山ヶ丘,11733,97,5671,41,6062,56,4054
13209042001,町田市,小山ヶ丘１丁目,2105,13,925,4,1180,9,517
13209042002,町田市,小山ヶ丘２丁目,644,13,303,5,341,8,237
13209042003,町田市,小山ヶ丘３丁目,1765,13,852,7,913,6,778
13209042004,町田市,小山ヶ丘４丁目,4201,45,2108,21,2093,24,1461
13209042005,町田市,小山ヶ丘５丁目,2576,13,1268,4,1308,9,927
13209042006,町田市,小山ヶ丘６丁目,442,0,215,0,227,0,134
132090430,町田市,金森東,7216,80,3459,40,3757,40,3109
13209043001,町田市,金森東１丁目,2058,38,973,21,1085,17,859
13209043002,町田市,金森東２丁目,1309,15,637,7,672,8,565
13209043003,町田市,金森東３丁目,1976,20,949,9,1027,11,877
13209043004,町田市,金森東４丁目,1873,7,900,3,973,4,808
132090440,町田市,西成瀬,5128,50,2532,28,2596,22,2067
13209044001,町田市,西成瀬１丁目,2493,19,1232,11,1261,8,988
13209044002,町田市,西成瀬２丁目,1939,28,946,14,993,14,819
13209044003,町田市,西成瀬３丁目,696,3,354,3,342,0,260
13210,小金井市,,121396,1796,60168,880,61228,916,59796
132100010,小金井市,東町,16715,338,8392,189,8323,149,8883
13210001001,小金井市,東町１丁目,3437,61,1626,31,1811,30,1481
13210001002,小金井市,東町２丁目,3065,65,1516,46,1549,19,1481
13210001003,小金井市,東町３丁目,2096,38,1101,21,995,17,1155
13210001004,小金井市,東町４丁目,5618,126,2893,66,2725,60,3584
13210001005,小金井市,東町５丁目,2499,48,1256,25,1243,23,1182
132100020,小金井市,梶野町,10099,142,5173,82,4926,60,5042
13210002001,小金井市,梶野町１丁目,912,3,469,2,443,1,475
13210002002,小金井市,梶野町２丁目,2430,60,1296,38,1134,22,1148
13210002003,小金井市,梶野町３丁目,2439,18,1230,11,1209,7,1100
13210002004,小金井市,梶野町４丁目,2569,32,1323,17,1246,15,1307
13210002005,小金井市,梶野町５丁目,1749,29,855,14,894,15,1012
132100030,小金井市,関野町,1256,13,639,6,617,7,589
13210003001,小金井市,関野町１丁目,598,4,299,1,299,3,293
13210003002,小金井市,関野町２丁目,658,9,340,5,318,4,296
132100040,小金井市,緑町,15785,244,7876,127,7909,117,7606
13210004001,小金井市,緑町１丁目,1811,20,910,11,901,9,873
13210004002,小金井市,緑町２丁目,3740,80,1878,52,1862,28,1700
13210004003,小金井市,緑町３丁目,2538,33,1298,14,1240,19,1173
13210004004,小金井市,緑町４丁目,2413,34,1173,15,1240,19,1084
13210004005,小金井市,緑町５丁目,5283,77,2617,35,2666,42,2776
132100050,小金井市,中町,12679,244,6418,131,6261,113,6202
13210005001,小金井市,中町１丁目,2198,28,1095,15,1103,13,976
13210005002,小金井市,中町２丁目,4431,127,2324,72,2107,55,2197
13210005003,小金井市,中町３丁目,4142,76,2060,37,2082,39,1988
13210005004,小金井市,中町４丁目,1908,13,939,7,969,6,1041
132100060,小金井市,前原町,14770,143,7307,65,7463,78,6669
13210006001,小金井市,前原町１丁目,1676,7,817,4,859,3,696
13210006002,小金井市,前原町２丁目,1866,15,940,9,926,6,840
13210006003,小金井市,前原町３丁目,4291,50,2116,21,2175,29,2173
13210006004,小金井市,前原町４丁目,4413,46,2200,22,2213,24,1807
13210006005,小金井市,前原町５丁目,2524,25,1234,9,1290,16,1153
132100070,小金井市,本町,20874,300,9901,124,10973,176,11348
13210007001,小金井市,本町１丁目,4276,72,2055,32,2221,40,2225
13210007002,小金井市,本町２丁目,3447,59,1635,20,1812,39,2041
13210007003,小金井市,本町３丁目,1999,29,970,12,1029,17,1068
13210007004,小金井市,本町４丁目,3341,37,1582,20,1759,17,1752
13210007005,小金井市,本町５丁目,5603,71,2668,27,2935,44,2984
13210007006,小金井市,本町６丁目,2208,32,991,13,1217,19,1278
132100080,小金井市,桜町,4339,52,2030,21,2309,31,1983
13210008001,小金井市,桜町１丁目,2507,22,1146,10,1361,12,1131
13210008002,小金井市,桜町２丁目,1368,18,654,7,714,11,632
13210008003,小金井市,桜町３丁目,464,12,230,4,234,8,220
132100090,小金井市,貫井北町,11746,149,5923,57,5823,92,5617
13210009001,小金井市,貫井北町１丁目,1878,23,909,10,969,13,999
13210009002,小金井市,貫井北町２丁目,1909,28,985,6,924,22,1017
13210009003,小金井市,貫井北町３丁目,5435,43,2786,21,2649,22,2366
13210009004,小金井市,貫井北町４丁目,225,27,122,10,103,17,96
13210009005,小金井市,貫井北町５丁目,2299,28,1121,10,1178,18,1139
132100100,小金井市,貫井南町,13133,171,6509,78,6624,93,5857
13210010001,小金井市,貫井南町１丁目,2702,24,1302,9,1400,15,1111
13210010002,小金井市,貫井南町２丁目,1953,31,955,15,998,16,806
13210010003,小金井市,貫井南町３丁目,2868,64,1395,29,1473,35,1345
13210010004,小金井市,貫井南町４丁目,3304,34,1721,15,1583,19,1519
13210010005,小金井市,貫井南町５丁目,2306,18,1136,10,1170,8,1076
13211,小平市,,190005,3971,93777,1938,96228,2033,82888
132110010,小平市,中島町,1799,27,879,14,920,13,845
132110020,小平市,上水新町,4556,70,2233,23,2323,47,1943
13211002001,小平市,上水新町１丁目,1556,8,774,1,782,7,607
13211002002,小平市,上水新町２丁目,1461,50,705,18,756,32,640
13211002003,小平市,上水新町３丁目,1539,12,754,4,785,8,696
132110030,小平市,たかの台,2031,31,972,15,1059,16,977
132110040,小平市,小川町,24184,1024,12056,535,12128,489,10262
13211004010,小平市,小川町１丁目,3688,140,1842,68,1846,72,1648
13211004011,小平市,小川町１丁目,5318,628,2579,349,2739,279,1714
13211004012,小平市,小川町１丁目,1543,14,780,5,763,9,754
13211004013,小平市,小川町１丁目,5085,124,2591,51,2494,73,2222
13211004014,小平市,小川町１丁目,2966,34,1429,17,1537,17,1306
13211004020,小平市,小川町２丁目,1942,35,990,18,952,17,904
13211004021,小平市,小川町２丁目,3642,49,1845,27,1797,22,1714
132110050,小平市,栄町,3235,53,1633,18,1602,35,1355
13211005001,小平市,栄町１丁目,702,12,354,3,348,9,332
13211005002,小平市,栄町２丁目,1658,39,854,14,804,25,648
13211005003,小平市,栄町３丁目,875,2,425,1,450,1,375
132110060,小平市,小川西町,8433,134,4085,63,4348,71,3749
13211006001,小平市,小川西町１丁目,1084,24,517,14,567,10,472
13211006002,小平市,小川西町２丁目,1934,39,941,15,993,24,708
13211006003,小平市,小川西町３丁目,1180,13,594,6,586,7,588
13211006004,小平市,小川西町４丁目,1544,33,743,20,801,13,833
13211006005,小平市,小川西町５丁目,2691,25,1290,8,1401,17,1148
132110081,小平市,小川東町,1570,5,756,2,814,3,663
132110082,小平市,小川東町,9799,160,4903,67,4896,93,4527
13211008201,小平市,小川東町１丁目,3021,48,1512,26,1509,22,1365
13211008202,小平市,小川東町２丁目,1485,23,657,7,828,16,595
13211008203,小平市,小川東町３丁目,1183,6,698,3,485,3,544
13211008204,小平市,小川東町４丁目,1338,40,619,15,719,25,820
13211008205,小平市,小川東町５丁目,2772,43,1417,16,1355,27,1203
132110090,小平市,上水本町,11256,120,5464,49,5792,71,4655
13211009001,小平市,上水本町１丁目,1709,19,791,8,918,11,791
13211009002,小平市,上水本町２丁目,1102,6,487,3,615,3,510
13211009003,小平市,上水本町３丁目,1015,11,497,6,518,5,394
13211009004,小平市,上水本町４丁目,1463,25,745,10,718,15,655
13211009005,小平市,上水本町５丁目,3524,51,1746,17,1778,34,1348
13211009006,小平市,上水本町６丁目,2443,8,1198,5,1245,3,957
132110100,小平市,上水南町,8153,118,4052,41,4101,77,3426
13211010001,小平市,上水南町１丁目,1800,25,877,13,923,12,796
13211010002,小平市,上水南町２丁目,2323,29,1161,12,1162,17,1077
13211010003,小平市,上水南町３丁目,2917,54,1422,12,1495,42,1149
13211010004,小平市,上水南町４丁目,1113,10,592,4,521,6,404
132110110,小平市,喜平町,6218,107,3197,49,3021,58,2915
13211011001,小平市,喜平町１丁目,1836,22,906,10,930,12,742
13211011002,小平市,喜平町２丁目,1412,15,871,7,541,8,494
13211011003,小平市,喜平町３丁目,2970,70,1420,32,1550,38,1679
132110120,小平市,津田町,5274,116,2270,46,3004,70,2269
13211012001,小平市,津田町１丁目,1026,14,473,8,553,6,501
13211012002,小平市,津田町２丁目,1653,26,651,8,1002,18,625
13211012003,小平市,津田町３丁目,2595,76,1146,30,1449,46,1143
132110130,小平市,学園西町,11059,707,5541,353,5518,354,5209
13211013001,小平市,学園西町１丁目,4803,623,2426,310,2377,313,2093
13211013002,小平市,学園西町２丁目,3812,54,1881,25,1931,29,1932
13211013003,小平市,学園西町３丁目,2444,30,1234,18,1210,12,1184
132110151,小平市,学園東町,2206,36,1051,15,1155,21,905
132110152,小平市,学園東町,7918,86,4046,41,3872,45,4106
13211015201,小平市,学園東町１丁目,3208,55,1576,29,1632,26,1677
13211015202,小平市,学園東町２丁目,2738,21,1393,8,1345,13,1367
13211015203,小平市,学園東町３丁目,1972,10,1077,4,895,6,1062
132110160,小平市,仲町,9099,104,4509,40,4590,64,4149
13211016000,小平市,仲町,5684,71,2844,28,2840,43,2648
13211016001,小平市,仲町,3415,33,1665,12,1750,21,1501
132110170,小平市,美園町,5421,104,2599,48,2822,56,2694
13211017001,小平市,美園町１丁目,2787,71,1321,35,1466,36,1496
13211017002,小平市,美園町２丁目,1057,15,526,7,531,8,567
13211017003,小平市,美園町３丁目,1577,18,752,6,825,12,631
132110180,小平市,回田町,4464,22,2245,11,2219,11,1820
132110190,小平市,御幸町,2435,22,1247,11,1188,11,1006
132110200,小平市,鈴木町,15317,179,7617,116,7700,63,5973
13211020010,小平市,鈴木町１丁目,1825,19,893,12,932,7,717
13211020011,小平市,鈴木町１丁目,1904,19,958,9,946,10,710
13211020012,小平市,鈴木町１丁目,6149,47,3037,29,3112,18,2266
13211020020,小平市,鈴木町２丁目,3010,76,1565,56,1445,20,1301
13211020021,小平市,鈴木町２丁目,2429,18,1164,10,1265,8,979
132110210,小平市,天神町,6381,83,3130,39,3251,44,2610
13211021001,小平市,天神町１丁目,2368,30,1155,14,1213,16,928
13211021002,小平市,天神町２丁目,1563,21,808,8,755,13,698
13211021003,小平市,天神町３丁目,312,2,143,2,169,0,130
13211021004,小平市,天神町４丁目,2138,30,1024,15,1114,15,854
132110220,小平市,大沼町,9943,186,4805,100,5138,86,3865
13211022001,小平市,大沼町１丁目,1647,52,789,30,858,22,653
13211022002,小平市,大沼町２丁目,1831,45,912,28,919,17,744
13211022003,小平市,大沼町３丁目,689,4,357,3,332,1,241
13211022004,小平市,大沼町４丁目,1903,13,979,7,924,6,744
13211022005,小平市,大沼町５丁目,577,5,292,3,285,2,199
13211022006,小平市,大沼町６丁目,619,6,292,4,327,2,227
13211022007,小平市,大沼町７丁目,2677,61,1184,25,1493,36,1057
132110230,小平市,花小金井南町,8552,155,4215,68,4337,87,4003
13211023001,小平市,花小金井南町１丁目,3466,78,1618,33,1848,45,1681
13211023002,小平市,花小金井南町２丁目,2119,49,1073,19,1046,30,1062
13211023003,小平市,花小金井南町３丁目,2967,28,1524,16,1443,12,1260
132110240,小平市,花小金井,20702,322,10272,174,10430,148,8962
13211024001,小平市,花小金井１丁目,3816,62,1879,34,1937,28,1788
13211024002,小平市,花小金井２丁目,2639,52,1325,31,1314,21,1210
13211024003,小平市,花小金井３丁目,2447,21,1160,10,1287,11,928
13211024004,小平市,花小金井４丁目,2513,34,1222,13,1291,21,1036
13211024005,小平市,花小金井５丁目,3190,22,1612,9,1578,13,1410
13211024006,小平市,花小金井６丁目,1973,51,949,26,1024,25,1017
13211024007,小平市,花小金井７丁目,2808,57,1442,41,1366,16,1083
13211024008,小平市,花小金井８丁目,1316,23,683,10,633,13,490
13212,日野市,,186283,2188,93349,1046,92934,1142,84928
132120010,日野市,多摩平,16378,255,7984,129,8394,126,7907
13212001001,日野市,多摩平１丁目,2981,36,1439,21,1542,15,1339
13212001002,日野市,多摩平２丁目,2717,60,1293,28,1424,32,1316
13212001003,日野市,多摩平３丁目,2368,40,1182,18,1186,22,1191
13212001004,日野市,多摩平４丁目,2555,33,1171,17,1384,16,1327
13212001005,日野市,多摩平５丁目,1627,29,855,16,772,13,770
13212001006,日野市,多摩平６丁目,2521,30,1261,19,1260,11,1162
13212001007,日野市,多摩平７丁目,1609,27,783,10,826,17,802
132120020,日野市,日野台,5613,57,2954,26,2659,31,2689
13212002001,日野市,日野台１丁目,1627,34,802,16,825,18,765
13212002002,日野市,日野台２丁目,1851,9,950,5,901,4,800
13212002003,日野市,日野台３丁目,292,X,291,X,1,X,291
13212002004,日野市,日野台４丁目,953,4,442,1,511,3,394
13212002005,日野市,日野台５丁目,890,10,469,4,421,6,439
132120030,日野市,さくら町,0,0,0,0,0,0,0
132120040,日野市,富士町,1850,15,912,7,938,8,628
132120050,日野市,栄町,5173,62,2517,26,2656,36,2307
13212005001,日野市,栄町１丁目,1410,22,683,11,727,11,662
13212005002,日野市,栄町２丁目,1558,27,757,11,801,16,746
13212005003,日野市,栄町３丁目,1016,5,499,0,517,5,410
13212005004,日野市,栄町４丁目,749,2,367,2,382,0,317
13212005005,日野市,栄町５丁目,440,6,211,2,229,4,172
132120061,日野市,新町,5945,58,2914,19,3031,39,2642
13212006101,日野市,新町１丁目,2327,28,1072,7,1255,21,1161
13212006102,日野市,新町２丁目,627,0,327,0,300,0,313
13212006103,日野市,新町３丁目,1564,16,784,4,780,12,732
13212006104,日野市,新町４丁目,855,9,439,5,416,4,259
13212006105,日野市,新町５丁目,572,5,292,3,280,2,177
132120062,日野市,新町,0,0,0,0,0,0,0
132120070,日野市,平山,8982,80,4437,39,4545,41,4227
13212007001,日野市,平山１丁目,504,7,236,2,268,5,203
13212007002,日野市,平山２丁目,1283,5,618,2,665,3,526
13212007003,日野市,平山３丁目,1607,4,777,3,830,1,740
13212007004,日野市,平山４丁目,2383,22,1129,9,1254,13,1138
13212007005,日野市,平山５丁目,1295,20,698,8,597,12,695
13212007006,日野市,平山６丁目,1910,22,979,15,931,7,925
132120080,日野市,東平山,4403,96,2141,49,2262,47,1954
13212008001,日野市,東平山１丁目,1646,76,804,41,842,35,936
13212008002,日野市,東平山２丁目,1322,10,653,5,669,5,555
13212008003,日野市,東平山３丁目,1435,10,684,3,751,7,463
132120090,日野市,西平山,6441,49,3289,21,3152,28,2622
13212009001,日野市,西平山１丁目,1456,9,711,7,745,2,543
13212009002,日野市,西平山２丁目,756,13,358,3,398,10,316
13212009003,日野市,西平山３丁目,628,3,340,1,288,2,300
13212009004,日野市,西平山４丁目,434,1,241,0,193,1,220
13212009005,日野市,西平山５丁目,3167,23,1639,10,1528,13,1243
132120100,日野市,大字豊田,106,0,53,0,53,0,39
132120110,日野市,豊田,6497,47,3215,23,3282,24,3015
13212011001,日野市,豊田１丁目,902,9,430,4,472,5,332
13212011002,日野市,豊田２丁目,1824,13,905,6,919,7,740
13212011003,日野市,豊田３丁目,2273,8,1128,4,1145,4,1180
13212011004,日野市,豊田４丁目,1498,17,752,9,746,8,763
132120120,日野市,東豊田,6928,66,3611,36,3317,30,3088
13212012001,日野市,東豊田１丁目,1961,10,1046,3,915,7,741
13212012002,日野市,東豊田２丁目,946,13,494,6,452,7,419
13212012003,日野市,東豊田３丁目,2217,29,1130,16,1087,13,1085
13212012004,日野市,東豊田４丁目,1804,14,941,11,863,3,843
132120130,日野市,旭が丘,12065,154,6163,68,5902,86,5232
13212013001,日野市,旭が丘１丁目,3421,25,1759,10,1662,15,1418
13212013002,日野市,旭が丘２丁目,3009,47,1581,25,1428,22,1494
13212013003,日野市,旭が丘３丁目,1097,8,550,2,547,6,471
13212013004,日野市,旭が丘４丁目,1614,38,795,18,819,20,619
13212013005,日野市,旭が丘５丁目,1631,20,824,6,807,14,689
13212013006,日野市,旭が丘６丁目,1293,16,654,7,639,9,541
132120150,日野市,南平,16847,146,8831,83,8016,63,7508
13212015001,日野市,南平１丁目,2361,23,1169,11,1192,12,997
13212015002,日野市,南平２丁目,3038,23,1480,12,1558,11,1221
13212015003,日野市,南平３丁目,1315,22,725,15,590,7,662
13212015004,日野市,南平４丁目,1803,17,891,9,912,8,771
13212015005,日野市,南平５丁目,2902,21,1470,8,1432,13,1374
13212015006,日野市,南平６丁目,1363,19,725,11,638,8,664
13212015007,日野市,南平７丁目,1607,12,1040,9,567,3,530
13212015008,日野市,南平８丁目,1262,6,748,5,514,1,761
13212015009,日野市,南平９丁目,1196,3,583,3,613,0,528
132120160,日野市,日野本町,6874,88,3427,42,3447,46,3420
13212016001,日野市,日野本町１丁目,423,15,217,9,206,6,222
13212016002,日野市,日野本町２丁目,1123,3,542,2,581,1,663
13212016003,日野市,日野本町３丁目,1061,14,520,6,541,8,569
13212016004,日野市,日野本町４丁目,1587,23,792,12,795,11,733
13212016005,日野市,日野本町５丁目,1382,19,678,8,704,11,607
13212016006,日野市,日野本町６丁目,774,9,412,3,362,6,343
13212016007,日野市,日野本町７丁目,524,5,266,2,258,3,283
132120170,日野市,神明,6251,65,3202,31,3049,34,2934
13212017001,日野市,神明１丁目,1609,19,799,9,810,10,724
13212017002,日野市,神明２丁目,1367,14,711,4,656,10,616
13212017003,日野市,神明３丁目,1390,17,722,9,668,8,692
13212017004,日野市,神明４丁目,1885,15,970,9,915,6,902
132120180,日野市,大坂上,5260,94,2676,34,2584,60,2634
13212018001,日野市,大坂上１丁目,966,4,523,2,443,2,527
13212018002,日野市,大坂上２丁目,1148,5,593,2,555,3,553
13212018003,日野市,大坂上３丁目,1684,41,789,12,895,29,816
13212018004,日野市,大坂上４丁目,1462,44,771,18,691,26,738
132120190,日野市,程久保,2087,18,1042,8,1045,10,993
132120200,日野市,程久保,5160,75,2662,34,2498,41,2569
13212020001,日野市,程久保１丁目,966,17,500,9,466,8,461
13212020002,日野市,程久保２丁目,985,4,459,2,526,2,441
13212020003,日野市,程久保３丁目,1301,14,676,7,625,7,652
13212020004,日野市,程久保４丁目,1,X,1,X,0,X,1
13212020005,日野市,程久保５丁目,37,6,24,2,13,4,25
13212020006,日野市,程久保６丁目,153,7,93,6,60,1,91
13212020007,日野市,程久保７丁目,7,X,4,X,3,X,2
13212020008,日野市,程久保８丁目,1710,27,905,8,805,19,896
132120210,日野市,大字日野,10945,77,5480,31,5465,46,4756
132120220,日野市,大字川辺堀之内,1337,13,678,9,659,4,503
132120270,日野市,大字新井,3979,61,1988,36,1991,25,1820
132120280,日野市,大字石田,1489,10,728,5,761,5,575
132120290,日野市,高幡,5008,99,2412,55,2596,44,2688
132120301,日野市,三沢,8516,170,4234,89,4282,81,3921
13212030101,日野市,三沢１丁目,1313,72,714,41,599,31,780
13212030102,日野市,三沢２丁目,2517,20,1209,6,1308,14,1036
13212030103,日野市,三沢３丁目,2112,41,1078,26,1034,15,948
13212030104,日野市,三沢４丁目,1375,25,642,13,733,12,604
13212030105,日野市,三沢５丁目,1199,12,591,3,608,9,553
132120302,日野市,三沢,2844,36,1361,14,1483,22,1318
13212030200,日野市,三沢,825,19,435,7,390,12,393
13212030201,日野市,三沢,2019,17,926,7,1093,10,925
132120310,日野市,落川,6005,68,2898,36,3107,32,2761
132120320,日野市,百草,8137,84,4024,43,4113,41,3742
132120361,日野市,万願寺,11442,109,5674,40,5768,69,4857
13212036101,日野市,万願寺１丁目,1806,13,815,2,991,11,659
13212036102,日野市,万願寺２丁目,2335,21,1161,9,1174,12,935
13212036103,日野市,万願寺３丁目,2470,16,1275,7,1195,9,1074
13212036104,日野市,万願寺４丁目,1605,19,817,7,788,12,797
13212036105,日野市,万願寺５丁目,864,13,452,2,412,11,398
13212036106,日野市,万願寺６丁目,2362,27,1154,13,1208,14,994
132120362,日野市,万願寺,0,0,0,0,0,0,0
13212036201,日野市,万願寺１丁目,0,0,0,0,0,0,0
13212036202,日野市,万願寺２丁目,0,0,0,0,0,0,0
132120371,日野市,石田,1931,18,983,9,948,9,857
13212037101,日野市,石田１丁目,1170,2,607,1,563,1,498
13212037102,日野市,石田２丁目,761,16,376,8,385,8,359
132120372,日野市,石田,0,0,0,0,0,0,0
132120380,日野市,大字上田,1225,15,582,3,643,12,525
132120390,日野市,大字宮,565,3,277,1,288,2,197
13213,東村山市,,149956,1959,73314,862,76642,1097,64604
132130010,東村山市,本町,11822,255,5732,100,6090,155,5944
13213001001,東村山市,本町１丁目,2334,60,1239,20,1095,40,1220
13213001002,東村山市,本町２丁目,2688,42,1357,19,1331,23,1423
13213001003,東村山市,本町３丁目,2414,35,1188,11,1226,24,1000
13213001004,東村山市,本町４丁目,4386,118,1948,50,2438,68,2301
132130020,東村山市,久米川町,16129,125,8041,54,8088,71,6437
13213002001,東村山市,久米川町１丁目,3651,33,1799,10,1852,23,1378
13213002002,東村山市,久米川町２丁目,3594,14,1762,8,1832,6,1266
13213002003,東村山市,久米川町３丁目,3251,33,1621,12,1630,21,1365
13213002004,東村山市,久米川町４丁目,3565,32,1804,20,1761,12,1570
13213002005,東村山市,久米川町５丁目,2068,13,1055,4,1013,9,858
132130030,東村山市,秋津町,16358,153,8116,65,8242,88,6917
13213003001,東村山市,秋津町１丁目,2054,10,998,5,1056,5,838
13213003002,東村山市,秋津町２丁目,2372,21,1215,9,1157,12,921
13213003003,東村山市,秋津町３丁目,3394,30,1676,13,1718,17,1404
13213003004,東村山市,秋津町４丁目,4766,41,2392,17,2374,24,1852
13213003005,東村山市,秋津町５丁目,3772,51,1835,21,1937,30,1902
132130040,東村山市,青葉町,11564,80,5537,33,6027,47,4405
13213004001,東村山市,青葉町１丁目,2506,16,1173,7,1333,9,824
13213004002,東村山市,青葉町２丁目,4599,24,2154,10,2445,14,1810
13213004003,東村山市,青葉町３丁目,4066,19,2019,6,2047,13,1492
13213004004,東村山市,青葉町４丁目,393,21,191,10,202,11,279
132130050,東村山市,恩多町,14853,146,7381,60,7472,86,5844
13213005001,東村山市,恩多町１丁目,3062,23,1587,14,1475,9,1142
13213005002,東村山市,恩多町２丁目,3724,33,1817,14,1907,19,1487
13213005003,東村山市,恩多町３丁目,2566,38,1290,17,1276,21,1072
13213005004,東村山市,恩多町４丁目,2064,26,1004,8,1060,18,767
13213005005,東村山市,恩多町５丁目,3437,26,1683,7,1754,19,1376
132130060,東村山市,萩山町,14271,336,6919,173,7352,163,6732
13213006001,東村山市,萩山町１丁目,3382,89,1783,45,1599,44,1692
13213006002,東村山市,萩山町２丁目,3122,46,1464,24,1658,22,1552
13213006003,東村山市,萩山町３丁目,4270,74,1983,29,2287,45,1730
13213006004,東村山市,萩山町４丁目,1573,57,809,43,764,14,757
13213006005,東村山市,萩山町５丁目,1924,70,880,32,1044,38,1001
132130070,東村山市,栄町,13992,318,6635,137,7357,181,7274
13213007001,東村山市,栄町１丁目,5263,129,2486,58,2777,71,2460
13213007002,東村山市,栄町２丁目,4314,91,2026,39,2288,52,2504
13213007003,東村山市,栄町３丁目,4415,98,2123,40,2292,58,2310
132130080,東村山市,富士見町,14198,85,6913,37,7285,48,5574
13213008001,東村山市,富士見町１丁目,5426,32,2708,16,2718,16,2161
13213008002,東村山市,富士見町２丁目,2886,26,1315,14,1571,12,930
13213008003,東村山市,富士見町３丁目,3398,15,1689,4,1709,11,1372
13213008004,東村山市,富士見町４丁目,1125,7,537,1,588,6,473
13213008005,東村山市,富士見町５丁目,1363,5,664,2,699,3,638
132130090,東村山市,美住町,10035,225,4839,97,5196,128,4343
13213009001,東村山市,美住町１丁目,7304,197,3497,86,3807,111,3127
13213009002,東村山市,美住町２丁目,2731,28,1342,11,1389,17,1216
132130100,東村山市,廻田町,6571,52,3330,26,3241,26,2666
13213010001,東村山市,廻田町１丁目,1845,22,934,13,911,9,744
13213010002,東村山市,廻田町２丁目,1269,11,649,7,620,4,533
13213010003,東村山市,廻田町３丁目,1465,7,736,1,729,6,628
13213010004,東村山市,廻田町４丁目,1992,12,1011,5,981,7,761
132130110,東村山市,多摩湖町,5363,54,2651,21,2712,33,2180
13213011001,東村山市,多摩湖町１丁目,1602,8,798,3,804,5,642
13213011002,東村山市,多摩湖町２丁目,1088,17,540,7,548,10,412
13213011003,東村山市,多摩湖町３丁目,1017,9,491,4,526,5,394
13213011004,東村山市,多摩湖町４丁目,1656,20,822,7,834,13,732
132130120,東村山市,諏訪町,5415,42,2528,19,2887,23,2139
13213012001,東村山市,諏訪町１丁目,2720,24,1311,10,1409,14,1221
13213012002,東村山市,諏訪町２丁目,2108,14,937,6,1171,8,724
13213012003,東村山市,諏訪町３丁目,587,4,280,3,307,1,194
132130130,東村山市,野口町,9385,88,4692,40,4693,48,4149
13213013001,東村山市,野口町１丁目,2920,42,1457,19,1463,23,1451
13213013002,東村山市,野口町２丁目,2710,29,1319,12,1391,17,1177
13213013003,東村山市,野口町３丁目,2196,11,1108,5,1088,6,900
13213013004,東村山市,野口町４丁目,1559,6,808,4,751,2,621
13214,国分寺市,,122742,1624,60274,756,62468,868,59130
132140010,国分寺市,東元町,9991,187,5050,95,4941,92,5337
13214001001,国分寺市,東元町１丁目,3784,67,1908,36,1876,31,2052
13214001002,国分寺市,東元町２丁目,2817,53,1427,24,1390,29,1491
13214001003,国分寺市,東元町３丁目,2082,56,1046,30,1036,26,1116
13214001004,国分寺市,東元町４丁目,1308,11,669,5,639,6,678
132140020,国分寺市,西元町,4048,46,2013,24,2035,22,1803
13214002001,国分寺市,西元町１丁目,543,9,267,5,276,4,198
13214002002,国分寺市,西元町２丁目,1638,16,808,7,830,9,781
13214002003,国分寺市,西元町３丁目,1484,10,748,5,736,5,671
13214002004,国分寺市,西元町４丁目,383,11,190,7,193,4,153
132140030,国分寺市,南町,7195,156,3301,60,3894,96,4712
13214003001,国分寺市,南町１丁目,990,13,488,8,502,5,542
13214003002,国分寺市,南町２丁目,2678,68,1198,31,1480,37,1721
13214003003,国分寺市,南町３丁目,3527,75,1615,21,1912,54,2449
132140040,国分寺市,泉町,9889,204,4800,96,5089,108,4621
13214004001,国分寺市,泉町１丁目,1437,30,720,16,717,14,769
13214004002,国分寺市,泉町２丁目,5190,124,2437,61,2753,63,2092
13214004003,国分寺市,泉町３丁目,3262,50,1643,19,1619,31,1760
132140050,国分寺市,本町,5990,126,2758,47,3232,79,3710
13214005001,国分寺市,本町１丁目,180,2,85,1,95,1,123
13214005002,国分寺市,本町２丁目,2291,50,1095,19,1196,31,1507
13214005003,国分寺市,本町３丁目,1258,21,633,9,625,12,809
13214005004,国分寺市,本町４丁目,2261,53,945,18,1316,35,1271
132140060,国分寺市,本多,9421,159,4781,83,4640,76,5159
13214006001,国分寺市,本多１丁目,1300,24,647,11,653,13,764
13214006002,国分寺市,本多２丁目,2206,41,1163,16,1043,25,1445
13214006003,国分寺市,本多３丁目,2038,14,1009,6,1029,8,935
13214006004,国分寺市,本多４丁目,1769,18,850,2,919,16,937
13214006005,国分寺市,本多５丁目,2108,62,1112,48,996,14,1078
132140070,国分寺市,東恋ケ窪,13114,186,6619,88,6495,98,5993
13214007001,国分寺市,東恋ケ窪１丁目,0,0,0,0,0,0,0
13214007002,国分寺市,東恋ケ窪２丁目,2566,35,1230,9,1336,26,1122
13214007003,国分寺市,東恋ケ窪３丁目,4398,70,2284,35,2114,35,1954
13214007004,国分寺市,東恋ケ窪４丁目,3207,58,1593,29,1614,29,1534
13214007005,国分寺市,東恋ケ窪５丁目,1098,3,561,3,537,0,500
13214007006,国分寺市,東恋ケ窪６丁目,1845,20,951,12,894,8,883
132140080,国分寺市,西恋ケ窪,5915,68,3025,35,2890,33,2883
13214008001,国分寺市,西恋ケ窪１丁目,2206,25,1098,10,1108,15,1080
13214008002,国分寺市,西恋ケ窪２丁目,842,12,423,9,419,3,390
13214008003,国分寺市,西恋ケ窪３丁目,1670,22,875,13,795,9,918
13214008004,国分寺市,西恋ケ窪４丁目,1197,9,629,3,568,6,495
132140090,国分寺市,東戸倉,3739,29,1824,17,1915,12,1749
13214009001,国分寺市,東戸倉１丁目,1615,15,798,9,817,6,736
13214009002,国分寺市,東戸倉２丁目,2124,14,1026,8,1098,6,1013
132140100,国分寺市,戸倉,7647,46,3725,17,3922,29,3225
13214010001,国分寺市,戸倉１丁目,1856,19,883,8,973,11,841
13214010002,国分寺市,戸倉２丁目,1561,10,775,3,786,7,694
13214010003,国分寺市,戸倉３丁目,1934,7,933,3,1001,4,766
13214010004,国分寺市,戸倉４丁目,2296,10,1134,3,1162,7,924
132140110,国分寺市,日吉町,7823,85,3800,42,4023,43,3503
13214011001,国分寺市,日吉町１丁目,2238,16,1096,7,1142,9,1017
13214011002,国分寺市,日吉町２丁目,2182,26,1089,14,1093,12,1117
13214011003,国分寺市,日吉町３丁目,1995,24,960,11,1035,13,841
13214011004,国分寺市,日吉町４丁目,1408,19,655,10,753,9,528
132140120,国分寺市,内藤,4672,18,2261,4,2411,14,2161
13214012001,国分寺市,内藤１丁目,2023,4,992,2,1031,2,927
13214012002,国分寺市,内藤２丁目,2649,14,1269,2,1380,12,1234
132140130,国分寺市,富士本,4612,46,2235,21,2377,25,2103
13214013001,国分寺市,富士本１丁目,2376,23,1157,11,1219,12,1159
13214013002,国分寺市,富士本２丁目,955,11,454,4,501,7,399
13214013003,国分寺市,富士本３丁目,1281,12,624,6,657,6,545
132140140,国分寺市,新町,3372,17,1658,7,1714,10,1305
13214014001,国分寺市,新町１丁目,979,4,488,3,491,1,361
13214014002,国分寺市,新町２丁目,1151,6,549,1,602,5,486
13214014003,国分寺市,新町３丁目,1242,7,621,3,621,4,458
132140150,国分寺市,並木町,3043,35,1482,14,1561,21,1138
13214015001,国分寺市,並木町１丁目,1540,20,786,9,754,11,605
13214015002,国分寺市,並木町２丁目,582,0,283,0,299,0,203
13214015003,国分寺市,並木町３丁目,921,15,413,5,508,10,330
132140160,国分寺市,北町,3376,25,1668,17,1708,8,1413
13214016001,国分寺市,北町１丁目,664,7,331,6,333,1,309
13214016002,国分寺市,北町２丁目,425,4,231,3,194,1,186
13214016003,国分寺市,北町３丁目,578,8,274,4,304,4,213
13214016004,国分寺市,北町４丁目,968,4,470,2,498,2,370
13214016005,国分寺市,北町５丁目,741,2,362,2,379,0,335
132140170,国分寺市,光町,6319,69,3162,29,3157,40,3065
13214017001,国分寺市,光町１丁目,3314,27,1613,9,1701,18,1598
13214017002,国分寺市,光町２丁目,1396,35,761,16,635,19,817
13214017003,国分寺市,光町３丁目,1609,7,788,4,821,3,650
132140180,国分寺市,高木町,2970,24,1437,12,1533,12,1189
13214018001,国分寺市,高木町１丁目,1022,7,498,3,524,4,421
13214018002,国分寺市,高木町２丁目,996,9,476,4,520,5,386
13214018003,国分寺市,高木町３丁目,952,8,463,5,489,3,382
132140190,国分寺市,西町,9606,98,4675,48,4931,50,4061
13214019001,国分寺市,西町１丁目,2241,20,1104,10,1137,10,922
13214019002,国分寺市,西町２丁目,2281,19,1097,9,1184,10,971
13214019003,国分寺市,西町３丁目,1675,16,824,9,851,7,685
13214019004,国分寺市,西町４丁目,1635,18,793,12,842,6,747
13214019005,国分寺市,西町５丁目,1774,25,857,8,917,17,736
13215,国立市,,73655,1241,35970,571,37685,670,34062
132150010,国立市,東,11793,218,5700,91,6093,127,5663
13215001001,国立市,東１丁目,3067,48,1404,17,1663,31,1580
13215001002,国立市,東２丁目,2771,37,1370,18,1401,19,1421
13215001003,国立市,東３丁目,2875,75,1433,33,1442,42,1304
13215001004,国立市,東４丁目,3080,58,1493,23,1587,35,1358
132150020,国立市,中,8783,243,4202,114,4581,129,4164
13215002001,国立市,中１丁目,3868,56,1861,21,2007,35,1962
13215002002,国立市,中２丁目,2752,158,1324,81,1428,77,1277
13215002003,国立市,中３丁目,2163,29,1017,12,1146,17,925
132150030,国立市,西,9473,143,4802,63,4671,80,4785
13215003001,国立市,西１丁目,3566,31,1801,14,1765,17,1776
13215003002,国立市,西２丁目,4622,82,2372,35,2250,47,2416
13215003003,国立市,西３丁目,1285,30,629,14,656,16,593
132150040,国立市,富士見台,16963,265,8248,129,8715,136,8127
13215004001,国立市,富士見台１丁目,5177,113,2518,55,2659,58,2560
13215004002,国立市,富士見台２丁目,3776,76,1914,40,1862,36,1837
13215004003,国立市,富士見台３丁目,3836,56,1882,27,1954,29,1759
13215004004,国立市,富士見台４丁目,4174,20,1934,7,2240,13,1971
132150050,国立市,北,8017,166,3781,78,4236,88,3743
13215005001,国立市,北１丁目,1856,20,852,8,1004,12,923
13215005002,国立市,北２丁目,2216,35,1122,19,1094,16,1108
13215005003,国立市,北３丁目,3945,111,1807,51,2138,60,1712
132150060,国立市,谷保,11029,104,5604,48,5425,56,4606
13215006001,国立市,谷保,2121,8,1061,4,1060,4,863
13215006002,国立市,谷保,2479,41,1247,16,1232,25,1101
13215006004,国立市,谷保,1295,8,648,3,647,5,567
13215006005,国立市,谷保,2177,26,1087,11,1090,15,843
13215006006,国立市,谷保,727,4,361,2,366,2,285
13215006007,国立市,谷保,1041,12,572,9,469,3,382
13215006008,国立市,谷保,663,2,326,1,337,1,303
13215006009,国立市,谷保,14,0,9,0,5,0,8
13215006010,国立市,谷保,259,2,162,2,97,0,152
13215006011,国立市,谷保６丁目,253,1,131,0,122,1,102
132150070,国立市,青柳,4719,72,2172,36,2547,36,1872
13215007000,国立市,青柳,1716,33,883,16,833,17,805
13215007001,国立市,青柳１丁目,1930,26,924,12,1006,14,795
13215007003,国立市,青柳３丁目,1073,13,365,8,708,5,272
132150080,国立市,石田,155,1,92,1,63,0,84
132150090,国立市,泉,2306,26,1150,11,1156,15,863
13215009001,国立市,泉１丁目,166,3,86,3,80,0,73
13215009002,国立市,泉２丁目,1193,18,594,5,599,13,479
13215009003,国立市,泉３丁目,579,4,274,2,305,2,168
13215009004,国立市,泉４丁目,178,0,97,0,81,0,72
13215009005,国立市,泉５丁目,190,1,99,1,91,0,71
132150100,国立市,矢川,417,3,219,0,198,3,155
13218,福生市,,58395,2455,29238,1267,29157,1188,27260
132180010,福生市,大字熊川,18341,757,9054,410,9287,347,8494
13218001090,福生市,大字熊川,9106,284,4422,155,4684,129,4060
13218001091,福生市,大字熊川,8291,441,4133,242,4158,199,3994
13218001092,福生市,大字熊川,944,32,499,13,445,19,440
132180020,福生市,大字福生,13433,572,6788,290,6645,282,6238
13218002090,福生市,大字福生,7762,314,3890,175,3872,139,3443
13218002091,福生市,大字福生,5671,258,2898,115,2773,143,2795
132180030,福生市,牛浜,2005,49,998,22,1007,27,1017
132180040,福生市,志茂,2938,57,1426,30,1512,27,1371
132180050,福生市,本町,1533,147,760,84,773,63,867
132180060,福生市,北田園,2226,55,1104,24,1122,31,865
13218006000,福生市,北田園,0,0,0,0,0,0,0
13218006001,福生市,北田園１丁目,1113,18,529,12,584,6,374
13218006002,福生市,北田園２丁目,1113,37,575,12,538,25,491
132180070,福生市,南田園,4730,106,2447,62,2283,44,2225
13218007000,福生市,南田園,6,0,6,0,0,0,6
13218007001,福生市,南田園１丁目,1210,52,610,37,600,15,470
13218007002,福生市,南田園２丁目,2084,31,1088,13,996,18,1088
13218007003,福生市,南田園３丁目,1430,23,743,12,687,11,661
132180080,福生市,武蔵野台,6224,334,3121,165,3103,169,2867
13218008001,福生市,武蔵野台１丁目,3570,207,1810,101,1760,106,1579
13218008002,福生市,武蔵野台２丁目,2654,127,1311,64,1343,63,1288
132180090,福生市,加美平,6209,347,3097,165,3112,182,3017
13218009001,福生市,加美平１丁目,1581,94,782,43,799,51,738
13218009002,福生市,加美平２丁目,1132,62,574,34,558,28,526
13218009003,福生市,加美平３丁目,1747,36,875,15,872,21,758
13218009004,福生市,加美平４丁目,1749,155,866,73,883,82,995
132180100,福生市,東町,369,30,184,14,185,16,177
132180110,福生市,横田基地内,171,0,155,0,16,0,8
132180120,福生市,大字熊川二宮,9,0,5,0,4,0,4
132180130,福生市,大字福生二宮,207,1,99,1,108,0,110
13219,狛江市,,80249,884,39206,443,41043,441,39458
132190010,狛江市,和泉本町,13426,145,6215,53,7211,92,6500
13219001001,狛江市,和泉本町１丁目,5806,93,2699,38,3107,55,2714
13219001002,狛江市,和泉本町２丁目,1473,7,730,3,743,4,685
13219001003,狛江市,和泉本町３丁目,2340,18,1129,7,1211,11,1014
13219001004,狛江市,和泉本町４丁目,3807,27,1657,5,2150,22,2087
132190020,狛江市,中和泉,11492,117,5756,68,5736,49,5675
13219002001,狛江市,中和泉１丁目,1881,25,933,15,948,10,1055
13219002002,狛江市,中和泉２丁目,1986,18,1009,9,977,9,912
13219002003,狛江市,中和泉３丁目,2700,19,1339,11,1361,8,1352
13219002004,狛江市,中和泉４丁目,1424,8,696,7,728,1,641
13219002005,狛江市,中和泉５丁目,3501,47,1779,26,1722,21,1715
132190030,狛江市,西和泉,2144,9,997,4,1147,5,1187
13219003001,狛江市,西和泉１丁目,1162,4,553,3,609,1,712
13219003002,狛江市,西和泉２丁目,982,5,444,1,538,4,475
132190040,狛江市,元和泉,3631,64,1816,37,1815,27,1947
13219004001,狛江市,元和泉１丁目,1280,43,621,24,659,19,691
13219004002,狛江市,元和泉２丁目,1512,9,760,6,752,3,743
13219004003,狛江市,元和泉３丁目,839,12,435,7,404,5,513
132190050,狛江市,東和泉,6336,65,2981,32,3355,33,3775
13219005001,狛江市,東和泉１丁目,2835,24,1295,14,1540,10,1781
13219005002,狛江市,東和泉２丁目,1208,15,594,7,614,8,699
13219005003,狛江市,東和泉３丁目,1710,16,815,6,895,10,928
13219005004,狛江市,東和泉４丁目,583,10,277,5,306,5,367
132190060,狛江市,猪方,6483,82,3354,42,3129,40,3312
13219006001,狛江市,猪方１丁目,1141,20,597,11,544,9,589
13219006002,狛江市,猪方２丁目,1421,19,734,11,687,8,667
13219006003,狛江市,猪方３丁目,2578,23,1310,12,1268,11,1361
13219006004,狛江市,猪方４丁目,1343,20,713,8,630,12,695
132190070,狛江市,駒井町,4388,39,2247,19,2141,20,1940
13219007001,狛江市,駒井町１丁目,1662,16,851,9,811,7,759
13219007002,狛江市,駒井町２丁目,1235,15,613,5,622,10,508
13219007003,狛江市,駒井町３丁目,1491,8,783,5,708,3,673
132190080,狛江市,岩戸南,9317,82,4581,44,4736,38,4316
13219008001,狛江市,岩戸南１丁目,2482,25,1217,14,1265,11,1215
13219008002,狛江市,岩戸南２丁目,2252,17,1082,12,1170,5,1073
13219008003,狛江市,岩戸南３丁目,2649,22,1321,12,1328,10,1307
13219008004,狛江市,岩戸南４丁目,1934,18,961,6,973,12,721
132190090,狛江市,岩戸北,8005,122,3882,63,4123,59,4310
13219009001,狛江市,岩戸北１丁目,1910,33,915,17,995,16,961
13219009002,狛江市,岩戸北２丁目,1097,23,554,13,543,10,631
13219009003,狛江市,岩戸北３丁目,3005,29,1419,15,1586,14,1576
13219009004,狛江市,岩戸北４丁目,1993,37,994,18,999,19,1142
132190100,狛江市,東野川,7748,74,3834,36,3914,38,3452
13219010001,狛江市,東野川１丁目,1886,17,938,8,948,9,927
13219010002,狛江市,東野川２丁目,1597,13,792,7,805,6,630
13219010003,狛江市,東野川３丁目,2373,15,1156,8,1217,7,1029
13219010004,狛江市,東野川４丁目,1892,29,948,13,944,16,866
132190110,狛江市,西野川,7279,85,3543,45,3736,40,3044
13219011001,狛江市,西野川１丁目,1817,40,891,15,926,25,833
13219011002,狛江市,西野川２丁目,1641,15,757,10,884,5,616
13219011003,狛江市,西野川３丁目,863,2,373,1,490,1,331
13219011004,狛江市,西野川４丁目,2958,28,1522,19,1436,9,1264
13220,東大和市,,85157,965,41820,349,43337,616,35555
132200010,東大和市,多摩湖,2,X,1,X,1,X,1
132200020,東大和市,芋窪,5200,23,2563,7,2637,16,1972
13220002001,東大和市,芋窪１丁目,556,3,280,0,276,3,207
13220002002,東大和市,芋窪２丁目,550,2,264,0,286,2,190
13220002003,東大和市,芋窪３丁目,903,1,438,1,465,0,319
13220002004,東大和市,芋窪４丁目,1535,10,744,3,791,7,570
13220002005,東大和市,芋窪５丁目,578,1,279,1,299,0,226
13220002006,東大和市,芋窪６丁目,1078,6,558,2,520,4,460
132200030,東大和市,蔵敷,4815,60,2413,22,2402,38,2178
13220003001,東大和市,蔵敷１丁目,312,0,156,0,156,0,116
13220003002,東大和市,蔵敷２丁目,1506,9,762,3,744,6,583
13220003003,東大和市,蔵敷３丁目,2997,51,1495,19,1502,32,1479
132200040,東大和市,奈良橋,4127,36,2055,13,2072,23,1587
13220004001,東大和市,奈良橋１丁目,739,6,360,2,379,4,262
13220004002,東大和市,奈良橋２丁目,415,2,209,1,206,1,168
13220004003,東大和市,奈良橋３丁目,748,7,372,3,376,4,292
13220004004,東大和市,奈良橋４丁目,383,2,185,1,198,1,155
13220004005,東大和市,奈良橋５丁目,954,11,488,3,466,8,382
13220004006,東大和市,奈良橋６丁目,888,8,441,3,447,5,328
132200050,東大和市,湖畔,2584,23,1247,7,1337,16,1026
13220005001,東大和市,湖畔１丁目,871,8,437,0,434,8,326
13220005002,東大和市,湖畔２丁目,968,8,443,3,525,5,398
13220005003,東大和市,湖畔３丁目,745,7,367,4,378,3,302
132200060,東大和市,高木,2935,17,1473,6,1462,11,1154
13220006001,東大和市,高木１丁目,410,3,216,1,194,2,156
13220006002,東大和市,高木２丁目,1068,7,520,1,548,6,412
13220006003,東大和市,高木３丁目,1457,7,737,4,720,3,586
132200070,東大和市,狭山,4033,15,2029,7,2004,8,1558
13220007001,東大和市,狭山１丁目,378,0,184,0,194,0,161
13220007002,東大和市,狭山２丁目,657,3,309,1,348,2,238
13220007003,東大和市,狭山３丁目,716,3,368,1,348,2,265
13220007004,東大和市,狭山４丁目,1286,6,662,4,624,2,526
13220007005,東大和市,狭山５丁目,996,3,506,1,490,2,368
132200080,東大和市,清水,5589,47,2793,20,2796,27,2345
13220008001,東大和市,清水１丁目,364,1,184,1,180,0,166
13220008002,東大和市,清水２丁目,980,15,489,7,491,8,430
13220008003,東大和市,清水３丁目,1058,9,535,5,523,4,450
13220008004,東大和市,清水４丁目,973,14,467,4,506,10,397
13220008005,東大和市,清水５丁目,829,3,410,1,419,2,320
13220008006,東大和市,清水６丁目,1385,5,708,2,677,3,582
132200090,東大和市,上北台,4505,162,2253,68,2252,94,2073
13220009001,東大和市,上北台１丁目,741,0,353,0,388,0,330
13220009002,東大和市,上北台２丁目,1852,146,908,62,944,84,896
13220009003,東大和市,上北台３丁目,1912,16,992,6,920,10,847
132200100,東大和市,桜が丘,15627,153,7551,58,8076,95,5875
13220010001,東大和市,桜が丘１丁目,4127,40,1965,14,2162,26,1457
13220010002,東大和市,桜が丘２丁目,5316,57,2602,17,2714,40,2001
13220010003,東大和市,桜が丘３丁目,3307,28,1556,14,1751,14,1355
13220010004,東大和市,桜が丘４丁目,2877,28,1428,13,1449,15,1062
132200110,東大和市,立野,4537,29,2231,11,2306,18,1954
13220011001,東大和市,立野１丁目,1143,9,575,5,568,4,472
13220011002,東大和市,立野２丁目,836,9,392,3,444,6,327
13220011003,東大和市,立野３丁目,2095,9,1020,3,1075,6,942
13220011004,東大和市,立野４丁目,463,2,244,0,219,2,213
132200120,東大和市,中央,4352,39,2214,9,2138,30,1736
13220012001,東大和市,中央１丁目,1515,13,791,4,724,9,590
13220012002,東大和市,中央２丁目,1530,13,787,1,743,12,621
13220012003,東大和市,中央３丁目,231,4,111,2,120,2,83
13220012004,東大和市,中央４丁目,1076,9,525,2,551,7,442
132200130,東大和市,南街,8173,85,4008,24,4165,61,3777
13220013001,東大和市,南街１丁目,1238,13,584,6,654,7,559
13220013002,東大和市,南街２丁目,1860,24,934,7,926,17,895
13220013003,東大和市,南街３丁目,1989,11,970,2,1019,9,818
13220013004,東大和市,南街４丁目,479,2,222,0,257,2,257
13220013005,東大和市,南街５丁目,1489,16,743,2,746,14,724
13220013006,東大和市,南街６丁目,1118,19,555,7,563,12,524
132200140,東大和市,仲原,3327,25,1626,10,1701,15,1220
13220014001,東大和市,仲原１丁目,327,0,158,0,169,0,119
13220014002,東大和市,仲原２丁目,865,1,435,1,430,0,314
13220014003,東大和市,仲原３丁目,1211,9,593,3,618,6,444
13220014004,東大和市,仲原４丁目,924,15,440,6,484,9,343
132200150,東大和市,向原,8740,160,4197,56,4543,104,4019
13220015001,東大和市,向原１丁目,1055,11,547,3,508,8,457
13220015002,東大和市,向原２丁目,603,3,301,1,302,2,252
13220015003,東大和市,向原３丁目,1432,43,661,16,771,27,633
13220015004,東大和市,向原４丁目,1971,43,986,18,985,25,863
13220015005,東大和市,向原５丁目,1004,18,485,7,519,11,457
13220015006,東大和市,向原６丁目,2675,42,1217,11,1458,31,1357
132200160,東大和市,清原,3153,57,1439,19,1714,38,1579
13220016001,東大和市,清原１丁目,348,7,166,2,182,5,205
13220016002,東大和市,清原２丁目,1153,20,506,8,647,12,599
13220016003,東大和市,清原３丁目,826,15,381,3,445,12,371
13220016004,東大和市,清原４丁目,826,15,386,6,440,9,404
132200170,東大和市,新堀,3458,34,1727,12,1731,22,1501
13220017001,東大和市,新堀１丁目,1270,10,640,4,630,6,569
13220017002,東大和市,新堀２丁目,968,9,487,4,481,5,412
13220017003,東大和市,新堀３丁目,1220,15,600,4,620,11,520
13221,清瀬市,,74864,969,35968,416,38896,553,32369
132210010,清瀬市,上清戸,3257,45,1602,29,1655,16,1494
13221001001,清瀬市,上清戸１丁目,1599,26,791,16,808,10,782
13221001002,清瀬市,上清戸２丁目,1658,19,811,13,847,6,712
132210020,清瀬市,元町,6170,104,2874,47,3296,57,3135
13221002001,清瀬市,元町１丁目,3317,60,1514,23,1803,37,1722
13221002002,清瀬市,元町２丁目,2853,44,1360,24,1493,20,1413
132210030,清瀬市,中清戸,8776,113,4228,50,4548,63,3378
13221003001,清瀬市,中清戸１丁目,1863,24,930,11,933,13,734
13221003002,清瀬市,中清戸２丁目,1127,17,550,10,577,7,434
13221003003,清瀬市,中清戸３丁目,1654,18,814,9,840,9,586
13221003004,清瀬市,中清戸４丁目,1701,35,789,13,912,22,738
13221003005,清瀬市,中清戸５丁目,2431,19,1145,7,1286,12,886
132210040,清瀬市,下清戸,4181,24,2062,6,2119,18,1521
13221004001,清瀬市,下清戸１丁目,1983,14,975,5,1008,9,732
13221004002,清瀬市,下清戸２丁目,682,5,343,1,339,4,257
13221004003,清瀬市,下清戸３丁目,352,0,171,0,181,0,132
13221004004,清瀬市,下清戸４丁目,617,1,301,0,316,1,217
13221004005,清瀬市,下清戸５丁目,547,4,272,0,275,4,183
132210050,清瀬市,下宿,3424,43,1748,19,1676,24,1489
13221005001,清瀬市,下宿１丁目,1696,23,873,8,823,15,879
13221005002,清瀬市,下宿２丁目,1268,16,638,9,630,7,443
13221005003,清瀬市,下宿３丁目,460,4,237,2,223,2,167
132210060,清瀬市,旭が丘,5998,85,2951,30,3047,55,2739
13221006001,清瀬市,旭が丘１丁目,1140,7,568,4,572,3,408
13221006002,清瀬市,旭が丘２丁目,2428,50,1167,17,1261,33,1333
13221006003,清瀬市,旭が丘３丁目,659,10,327,4,332,6,210
13221006004,清瀬市,旭が丘４丁目,72,0,40,0,32,0,25
13221006005,清瀬市,旭が丘５丁目,1068,12,531,4,537,8,563
13221006006,清瀬市,旭が丘６丁目,631,6,318,1,313,5,200
132210070,清瀬市,中里,11943,125,5906,60,6037,65,4854
13221007001,清瀬市,中里１丁目,1860,19,935,18,925,1,766
13221007002,清瀬市,中里２丁目,1578,16,778,10,800,6,664
13221007003,清瀬市,中里３丁目,2887,20,1449,12,1438,8,1100
13221007004,清瀬市,中里４丁目,1706,15,800,5,906,10,704
13221007005,清瀬市,中里５丁目,2282,33,1125,12,1157,21,830
13221007006,清瀬市,中里６丁目,1630,22,819,3,811,19,790
132210080,清瀬市,野塩,8361,124,3938,53,4423,71,3913
13221008001,清瀬市,野塩１丁目,2542,33,1228,16,1314,17,1238
13221008002,清瀬市,野塩２丁目,1456,36,654,17,802,19,738
13221008003,清瀬市,野塩３丁目,918,9,436,2,482,7,364
13221008004,清瀬市,野塩４丁目,1281,5,633,3,648,2,523
13221008005,清瀬市,野塩５丁目,2164,41,987,15,1177,26,1050
132210090,清瀬市,松山,7868,151,3790,61,4078,90,4128
13221009001,清瀬市,松山１丁目,3495,64,1671,24,1824,40,1820
13221009002,清瀬市,松山２丁目,2651,60,1302,27,1349,33,1472
13221009003,清瀬市,松山３丁目,1722,27,817,10,905,17,836
132210100,清瀬市,竹丘,11205,127,5198,51,6007,76,4424
13221010001,清瀬市,竹丘１丁目,3857,48,1730,17,2127,31,1553
13221010002,清瀬市,竹丘２丁目,3674,53,1647,24,2027,29,1519
13221010003,清瀬市,竹丘３丁目,3674,26,1821,10,1853,16,1352
132210110,清瀬市,梅園,3681,28,1671,10,2010,18,1294
13221011001,清瀬市,梅園１丁目,151,1,60,1,91,0,18
13221011002,清瀬市,梅園２丁目,1094,6,461,2,633,4,369
13221011003,清瀬市,梅園３丁目,2436,21,1150,7,1286,14,907
13222,東久留米市,,116632,1558,56738,640,59894,918,49902
132220010,東久留米市,上の原,1771,42,806,25,965,17,1002
13222001001,東久留米市,上の原１丁目,1604,40,730,24,874,16,932
13222001002,東久留米市,上の原２丁目,167,2,76,1,91,1,70
132220020,東久留米市,神宝町,2481,26,1224,7,1257,19,984
13222002001,東久留米市,神宝町１丁目,1313,17,636,5,677,12,526
13222002002,東久留米市,神宝町２丁目,1168,9,588,2,580,7,458
132220030,東久留米市,金山町,3099,24,1504,9,1595,15,1305
13222003001,東久留米市,金山町１丁目,1235,16,603,8,632,8,551
13222003002,東久留米市,金山町２丁目,1864,8,901,1,963,7,754
132220040,東久留米市,氷川台,3449,80,1614,35,1835,45,1345
13222004001,東久留米市,氷川台１丁目,1268,59,601,24,667,35,503
13222004002,東久留米市,氷川台２丁目,2181,21,1013,11,1168,10,842
132220050,東久留米市,大門町,3125,44,1555,19,1570,25,1405
13222005001,東久留米市,大門町１丁目,412,1,209,0,203,1,204
13222005002,東久留米市,大門町２丁目,2713,43,1346,19,1367,24,1201
132220060,東久留米市,東本町,2678,66,1248,20,1430,46,1384
132220070,東久留米市,新川町,2715,80,1320,47,1395,33,1285
13222007001,東久留米市,新川町１丁目,1696,56,835,35,861,21,836
13222007002,東久留米市,新川町２丁目,1019,24,485,12,534,12,449
132220080,東久留米市,浅間町,5847,110,2894,44,2953,66,2635
13222008001,東久留米市,浅間町１丁目,1328,16,650,8,678,8,553
13222008002,東久留米市,浅間町２丁目,2139,48,1074,19,1065,29,838
13222008003,東久留米市,浅間町３丁目,2380,46,1170,17,1210,29,1244
132220090,東久留米市,学園町,3350,29,1618,12,1732,17,1295
13222009001,東久留米市,学園町１丁目,1971,20,968,9,1003,11,687
13222009002,東久留米市,学園町２丁目,1379,9,650,3,729,6,608
132220100,東久留米市,ひばりが丘団地,2146,58,1027,22,1119,36,952
132220110,東久留米市,本町,6988,140,3255,58,3733,82,3298
13222011001,東久留米市,本町１丁目,2514,69,1160,26,1354,43,1205
13222011002,東久留米市,本町２丁目,1396,25,668,10,728,15,706
13222011003,東久留米市,本町３丁目,2149,18,977,5,1172,13,968
13222011004,東久留米市,本町４丁目,929,28,450,17,479,11,419
132220120,東久留米市,小山,5827,78,2902,34,2925,44,2383
13222012001,東久留米市,小山１丁目,828,7,410,3,418,4,398
13222012002,東久留米市,小山２丁目,789,21,399,8,390,13,338
13222012003,東久留米市,小山３丁目,1688,12,855,4,833,8,666
13222012004,東久留米市,小山４丁目,836,13,396,9,440,4,319
13222012005,東久留米市,小山５丁目,1686,25,842,10,844,15,662
132220130,東久留米市,幸町,5301,82,2535,42,2766,40,2269
13222013001,東久留米市,幸町１丁目,1330,32,613,15,717,17,676
13222013002,東久留米市,幸町２丁目,1213,10,580,3,633,7,472
13222013003,東久留米市,幸町３丁目,1704,14,821,7,883,7,669
13222013004,東久留米市,幸町４丁目,702,21,337,13,365,8,321
13222013005,東久留米市,幸町５丁目,352,5,184,4,168,1,131
132220140,東久留米市,中央町,8226,82,4028,31,4198,51,3286
13222014001,東久留米市,中央町１丁目,2392,41,1160,15,1232,26,995
13222014002,東久留米市,中央町２丁目,1067,9,511,3,556,6,541
13222014003,東久留米市,中央町３丁目,1411,8,683,3,728,5,496
13222014004,東久留米市,中央町４丁目,984,11,470,5,514,6,364
13222014005,東久留米市,中央町５丁目,1490,10,751,4,739,6,529
13222014006,東久留米市,中央町６丁目,882,3,453,1,429,2,361
132220150,東久留米市,南沢,7597,79,3661,29,3936,50,2829
13222015001,東久留米市,南沢１丁目,1605,26,795,13,810,13,630
13222015002,東久留米市,南沢２丁目,785,4,375,0,410,4,309
13222015003,東久留米市,南沢３丁目,1347,10,664,2,683,8,512
13222015004,東久留米市,南沢４丁目,993,13,499,4,494,9,382
13222015005,東久留米市,南沢５丁目,2867,26,1328,10,1539,16,996
132220160,東久留米市,前沢,9139,75,4539,35,4600,40,3857
13222016001,東久留米市,前沢１丁目,1372,9,707,2,665,7,570
13222016002,東久留米市,前沢２丁目,1578,12,752,4,826,8,668
13222016003,東久留米市,前沢３丁目,1972,13,978,5,994,8,783
13222016004,東久留米市,前沢４丁目,1669,10,810,4,859,6,708
13222016005,東久留米市,前沢５丁目,2548,31,1292,20,1256,11,1128
132220170,東久留米市,南町,4480,43,2146,15,2334,28,1755
13222017001,東久留米市,南町１丁目,2043,23,961,11,1082,12,850
13222017002,東久留米市,南町２丁目,184,0,90,0,94,0,94
13222017003,東久留米市,南町３丁目,1070,13,531,2,539,11,381
13222017004,東久留米市,南町４丁目,1183,7,564,2,619,5,430
132220180,東久留米市,滝山,10473,92,4968,38,5505,54,4911
13222018001,東久留米市,滝山１丁目,642,2,308,0,334,2,230
13222018002,東久留米市,滝山２丁目,700,6,317,2,383,4,332
13222018003,東久留米市,滝山３丁目,1247,5,584,3,663,2,569
13222018004,東久留米市,滝山４丁目,682,9,327,4,355,5,263
13222018005,東久留米市,滝山５丁目,1529,13,735,6,794,7,595
13222018006,東久留米市,滝山６丁目,4395,47,2030,21,2365,26,2369
13222018007,東久留米市,滝山７丁目,1278,10,667,2,611,8,553
132220190,東久留米市,下里,12551,150,6385,50,6166,100,5477
13222019001,東久留米市,下里１丁目,1593,10,778,5,815,5,586
13222019002,東久留米市,下里２丁目,1807,5,899,2,908,3,663
13222019003,東久留米市,下里３丁目,1437,9,761,3,676,6,617
13222019004,東久留米市,下里４丁目,3413,68,1753,19,1660,49,1861
13222019005,東久留米市,下里５丁目,1631,18,837,7,794,11,567
13222019006,東久留米市,下里６丁目,830,3,436,2,394,1,281
13222019007,東久留米市,下里７丁目,1840,37,921,12,919,25,902
132220200,東久留米市,柳窪,5404,53,2702,23,2702,30,2219
13222020001,東久留米市,柳窪１丁目,700,9,348,3,352,6,260
13222020002,東久留米市,柳窪２丁目,2851,29,1436,15,1415,14,1266
13222020003,東久留米市,柳窪３丁目,347,2,167,1,180,1,162
13222020004,東久留米市,柳窪４丁目,980,9,492,3,488,6,356
13222020005,東久留米市,柳窪５丁目,526,4,259,1,267,3,175
132220210,東久留米市,野火止,2868,35,1394,11,1474,24,1143
13222021001,東久留米市,野火止１丁目,244,0,117,0,127,0,100
13222021002,東久留米市,野火止２丁目,1274,6,614,1,660,5,503
13222021003,東久留米市,野火止３丁目,1350,29,663,10,687,19,540
132220220,東久留米市,八幡町,5665,83,2726,32,2939,51,2344
13222022001,東久留米市,八幡町１丁目,2269,39,1051,22,1218,17,932
13222022002,東久留米市,八幡町２丁目,2046,37,1010,9,1036,28,890
13222022003,東久留米市,八幡町３丁目,1350,7,665,1,685,6,522
132220230,東久留米市,弥生,1452,7,687,2,765,5,539
13222023001,東久留米市,弥生１丁目,962,6,486,2,476,4,402
13222023002,東久留米市,弥生２丁目,490,1,201,0,289,1,137
13223,武蔵村山市,,71229,1054,35556,434,35673,620,28300
132230010,武蔵村山市,大字三ツ木,0,0,0,0,0,0,0
132230020,武蔵村山市,大字岸,0,0,0,0,0,0,0
132230030,武蔵村山市,大南,13641,158,6996,75,6645,83,5682
13223003001,武蔵村山市,大南１丁目,3837,49,1972,23,1865,26,1509
13223003002,武蔵村山市,大南２丁目,2717,32,1404,16,1313,16,1098
13223003003,武蔵村山市,大南３丁目,3674,39,1901,18,1773,21,1557
13223003004,武蔵村山市,大南４丁目,1718,21,886,13,832,8,809
13223003005,武蔵村山市,大南５丁目,1695,17,833,5,862,12,709
132230040,武蔵村山市,学園,6992,74,3533,29,3459,45,2608
13223004001,武蔵村山市,学園１丁目,2132,33,1061,15,1071,18,801
13223004002,武蔵村山市,学園２丁目,1132,7,558,3,574,4,391
13223004003,武蔵村山市,学園３丁目,1510,15,764,2,746,13,637
13223004004,武蔵村山市,学園４丁目,1748,14,915,7,833,7,597
13223004005,武蔵村山市,学園５丁目,470,5,235,2,235,3,182
132230050,武蔵村山市,榎,2508,45,1278,16,1230,29,1002
13223005001,武蔵村山市,榎１丁目,58,0,27,0,31,0,16
13223005002,武蔵村山市,榎２丁目,1580,39,799,14,781,25,620
13223005003,武蔵村山市,榎３丁目,870,6,452,2,418,4,366
132230060,武蔵村山市,伊奈平,5142,161,2553,63,2589,98,1957
13223006001,武蔵村山市,伊奈平１丁目,354,32,188,17,166,15,154
13223006002,武蔵村山市,伊奈平２丁目,348,1,182,0,166,1,134
13223006003,武蔵村山市,伊奈平３丁目,384,21,211,11,173,10,164
13223006004,武蔵村山市,伊奈平４丁目,954,24,449,9,505,15,337
13223006005,武蔵村山市,伊奈平５丁目,1869,44,951,17,918,27,693
13223006006,武蔵村山市,伊奈平６丁目,1233,39,572,9,661,30,475
132230070,武蔵村山市,残堀,5749,74,2923,28,2826,46,2097
13223007001,武蔵村山市,残堀１丁目,1036,17,522,8,514,9,387
13223007002,武蔵村山市,残堀２丁目,982,16,503,5,479,11,384
13223007003,武蔵村山市,残堀３丁目,0,0,0,0,0,0,0
13223007004,武蔵村山市,残堀４丁目,1672,28,840,10,832,18,626
13223007005,武蔵村山市,残堀５丁目,2059,13,1058,5,1001,8,700
132230080,武蔵村山市,三ツ藤,4907,97,2407,44,2500,53,1778
13223008001,武蔵村山市,三ツ藤１丁目,2717,73,1308,35,1409,38,986
13223008002,武蔵村山市,三ツ藤２丁目,790,11,399,4,391,7,294
13223008003,武蔵村山市,三ツ藤３丁目,1400,13,700,5,700,8,498
132230090,武蔵村山市,神明,3861,20,2000,7,1861,13,1481
13223009001,武蔵村山市,神明１丁目,590,4,299,1,291,3,251
13223009002,武蔵村山市,神明２丁目,1384,7,718,3,666,4,497
13223009003,武蔵村山市,神明３丁目,891,5,473,1,418,4,332
13223009004,武蔵村山市,神明４丁目,996,4,510,2,486,2,401
132230100,武蔵村山市,中藤,2484,23,1244,8,1240,15,864
13223010001,武蔵村山市,中藤１丁目,607,8,310,2,297,6,213
13223010002,武蔵村山市,中藤２丁目,149,0,79,0,70,0,50
13223010003,武蔵村山市,中藤３丁目,435,2,227,1,208,1,154
13223010004,武蔵村山市,中藤４丁目,692,10,343,3,349,7,253
13223010005,武蔵村山市,中藤５丁目,601,3,285,2,316,1,194
132230110,武蔵村山市,中央,3367,41,1728,23,1639,18,1250
13223011001,武蔵村山市,中央１丁目,972,25,487,17,485,8,348
13223011002,武蔵村山市,中央２丁目,1152,11,594,6,558,5,428
13223011003,武蔵村山市,中央３丁目,875,3,463,0,412,3,339
13223011004,武蔵村山市,中央４丁目,368,2,184,0,184,2,135
13223011005,武蔵村山市,中央５丁目,0,0,0,0,0,0,0
132230120,武蔵村山市,本町,3692,48,1858,18,1834,30,1409
13223012001,武蔵村山市,本町１丁目,1137,21,576,11,561,10,463
13223012002,武蔵村山市,本町２丁目,1285,20,635,6,650,14,477
13223012003,武蔵村山市,本町３丁目,561,3,295,0,266,3,215
13223012004,武蔵村山市,本町４丁目,437,4,219,1,218,3,159
13223012005,武蔵村山市,本町５丁目,241,0,120,0,121,0,84
13223012006,武蔵村山市,本町６丁目,31,0,13,0,18,0,11
132230130,武蔵村山市,緑が丘,7401,173,3166,64,4235,109,3878
13223013000,武蔵村山市,緑が丘,5158,140,2175,53,2983,87,2617
13223013001,武蔵村山市,緑が丘,2243,33,991,11,1252,22,1261
132230140,武蔵村山市,三ツ木,4010,36,2032,16,1978,20,1449
13223014001,武蔵村山市,三ツ木１丁目,1314,17,672,10,642,7,487
13223014002,武蔵村山市,三ツ木２丁目,981,5,489,2,492,3,357
13223014003,武蔵村山市,三ツ木３丁目,841,3,424,1,417,2,309
13223014004,武蔵村山市,三ツ木４丁目,0,0,0,0,0,0,0
13223014005,武蔵村山市,三ツ木５丁目,874,11,447,3,427,8,296
132230150,武蔵村山市,岸,2764,43,1461,22,1303,21,1131
13223015001,武蔵村山市,岸１丁目,1208,21,663,11,545,10,533
13223015002,武蔵村山市,岸２丁目,519,9,263,6,256,3,199
13223015003,武蔵村山市,岸３丁目,957,12,490,5,467,7,369
13223015004,武蔵村山市,岸４丁目,0,0,0,0,0,0,0
13223015005,武蔵村山市,岸５丁目,80,1,45,0,35,1,30
132230160,武蔵村山市,中原,4711,61,2377,21,2334,40,1714
13223016001,武蔵村山市,中原１丁目,1180,17,597,6,583,11,430
13223016002,武蔵村山市,中原２丁目,1800,27,904,10,896,17,708
13223016003,武蔵村山市,中原３丁目,1305,11,682,3,623,8,416
13223016004,武蔵村山市,中原４丁目,426,6,194,2,232,4,160
13223016005,武蔵村山市,中原５丁目,0,0,0,0,0,0,0
13224,多摩市,,146631,1768,71762,730,74869,1038,65461
132240011,多摩市,関戸,0,0,0,0,0,0,0
132240012,多摩市,関戸,9039,109,4386,52,4653,57,4386
13224001201,多摩市,関戸１丁目,892,8,385,3,507,5,383
13224001202,多摩市,関戸２丁目,2514,48,1249,29,1265,19,1293
13224001203,多摩市,関戸３丁目,1411,15,683,4,728,11,654
13224001204,多摩市,関戸４丁目,2105,24,1012,10,1093,14,1115
13224001205,多摩市,関戸５丁目,1319,11,656,4,663,7,603
13224001206,多摩市,関戸６丁目,798,3,401,2,397,1,338
132240021,多摩市,連光寺,0,0,0,0,0,0,0
132240022,多摩市,連光寺,10080,107,5012,47,5068,60,3722
13224002201,多摩市,連光寺１丁目,3956,41,1938,16,2018,25,1398
13224002202,多摩市,連光寺２丁目,2793,18,1387,7,1406,11,901
13224002203,多摩市,連光寺３丁目,1745,31,874,16,871,15,750
13224002204,多摩市,連光寺４丁目,554,2,280,0,274,2,242
13224002205,多摩市,連光寺５丁目,304,1,145,0,159,1,127
13224002206,多摩市,連光寺６丁目,728,14,388,8,340,6,304
132240030,多摩市,貝取,1112,13,597,6,515,7,571
132240040,多摩市,乞田,2526,24,1313,9,1213,15,1157
132240061,多摩市,和田,10561,78,5361,40,5200,38,4438
13224006100,多摩市,和田,9115,50,4682,28,4433,22,3572
13224006101,多摩市,和田,1446,28,679,12,767,16,866
132240070,多摩市,百草,828,4,434,2,394,2,365
132240080,多摩市,落川,1168,13,596,6,572,7,496
132240091,多摩市,東寺方,1476,7,773,1,703,6,682
132240092,多摩市,東寺方,1377,11,631,2,746,9,664
13224009201,多摩市,東寺方１丁目,971,9,470,2,501,7,443
13224009203,多摩市,東寺方３丁目,406,2,161,0,245,2,221
132240100,多摩市,一ノ宮,6079,131,3116,42,2963,89,3419
13224010001,多摩市,一ノ宮１丁目,1995,46,1081,15,914,31,1224
13224010002,多摩市,一ノ宮２丁目,1443,27,726,13,717,14,817
13224010003,多摩市,一ノ宮３丁目,800,10,398,2,402,8,429
13224010004,多摩市,一ノ宮４丁目,1841,48,911,12,930,36,949
132240110,多摩市,桜ケ丘,5884,110,2781,50,3103,60,2648
13224011001,多摩市,桜ケ丘１丁目,1922,39,933,15,989,24,901
13224011002,多摩市,桜ケ丘２丁目,1242,10,559,4,683,6,525
13224011003,多摩市,桜ケ丘３丁目,1228,11,582,5,646,6,489
13224011004,多摩市,桜ケ丘４丁目,1492,50,707,26,785,24,733
132240120,多摩市,聖ケ丘,6774,43,3245,13,3529,30,2748
13224012001,多摩市,聖ケ丘１丁目,1917,26,896,7,1021,19,791
13224012002,多摩市,聖ケ丘２丁目,1872,4,862,0,1010,4,787
13224012003,多摩市,聖ケ丘３丁目,2152,9,1081,4,1071,5,864
13224012004,多摩市,聖ケ丘４丁目,731,3,348,2,383,1,275
13224012005,多摩市,聖ケ丘５丁目,102,1,58,0,44,1,31
132240130,多摩市,諏訪,11725,177,5545,69,6180,108,5360
13224013001,多摩市,諏訪１丁目,4221,60,2079,21,2142,39,1886
13224013002,多摩市,諏訪２丁目,3625,39,1723,18,1902,21,1525
13224013003,多摩市,諏訪３丁目,1083,23,541,13,542,10,445
13224013004,多摩市,諏訪４丁目,2002,29,857,9,1145,20,1083
13224013005,多摩市,諏訪５丁目,794,26,345,8,449,18,421
13224013006,多摩市,諏訪６丁目,0,0,0,0,0,0,0
132240140,多摩市,永山,15067,176,7396,73,7671,103,7291
13224014001,多摩市,永山１丁目,1936,26,965,9,971,17,1036
13224014002,多摩市,永山２丁目,3106,36,1567,17,1539,19,1470
13224014003,多摩市,永山３丁目,3576,40,1721,19,1855,21,1578
13224014004,多摩市,永山４丁目,3227,58,1566,24,1661,34,1841
13224014005,多摩市,永山５丁目,1990,8,958,2,1032,6,786
13224014006,多摩市,永山６丁目,1232,8,619,2,613,6,580
13224014007,多摩市,永山７丁目,0,0,0,0,0,0,0
132240150,多摩市,貝取,8284,72,3961,28,4323,44,3479
13224015001,多摩市,貝取１丁目,1848,12,951,6,897,6,808
13224015002,多摩市,貝取２丁目,3614,37,1726,14,1888,23,1429
13224015003,多摩市,貝取３丁目,1129,9,490,6,639,3,458
13224015004,多摩市,貝取４丁目,1098,3,523,0,575,3,488
13224015005,多摩市,貝取５丁目,595,11,271,2,324,9,296
132240160,多摩市,豊ケ丘,10472,102,5058,52,5414,50,4639
13224016001,多摩市,豊ケ丘１丁目,2968,52,1494,29,1474,23,1371
13224016002,多摩市,豊ケ丘２丁目,2875,22,1412,12,1463,10,1199
13224016003,多摩市,豊ケ丘３丁目,1692,5,788,2,904,3,657
13224016004,多摩市,豊ケ丘４丁目,666,8,313,4,353,4,354
13224016005,多摩市,豊ケ丘５丁目,1315,7,615,2,700,5,600
13224016006,多摩市,豊ケ丘６丁目,956,8,436,3,520,5,458
132240170,多摩市,落合,13887,170,6769,67,7118,103,6115
13224017001,多摩市,落合１丁目,2356,42,1116,17,1240,25,1167
13224017002,多摩市,落合２丁目,2223,34,1123,13,1100,21,846
13224017003,多摩市,落合３丁目,3077,48,1504,20,1573,28,1434
13224017004,多摩市,落合４丁目,2276,28,1055,10,1221,18,1060
13224017005,多摩市,落合５丁目,2248,5,1104,0,1144,5,872
13224017006,多摩市,落合６丁目,1707,13,867,7,840,6,736
132240180,多摩市,鶴牧,11819,135,5758,54,6061,81,4797
13224018001,多摩市,鶴牧１丁目,2108,46,1046,18,1062,28,939
13224018002,多摩市,鶴牧２丁目,1639,13,827,5,812,8,793
13224018003,多摩市,鶴牧３丁目,3499,40,1686,16,1813,24,1230
13224018004,多摩市,鶴牧４丁目,787,4,379,2,408,2,304
13224018005,多摩市,鶴牧５丁目,1996,20,941,9,1055,11,796
13224018006,多摩市,鶴牧６丁目,1790,12,879,4,911,8,735
132240190,多摩市,南野,1876,27,974,7,902,20,872
13224019001,多摩市,南野１丁目,3,X,2,X,1,X,1
13224019002,多摩市,南野２丁目,950,18,508,4,442,14,499
13224019003,多摩市,南野３丁目,923,9,464,3,459,6,372
132240210,多摩市,和田,1095,15,477,3,618,12,604
132240220,多摩市,愛宕,5208,90,2458,37,2750,53,2539
13224022001,多摩市,愛宕１丁目,684,11,330,4,354,7,368
13224022002,多摩市,愛宕２丁目,932,4,464,2,468,2,445
13224022003,多摩市,愛宕３丁目,865,15,378,6,487,9,468
13224022004,多摩市,愛宕４丁目,2727,60,1286,25,1441,35,1258
132240240,多摩市,馬引沢,4022,54,2138,29,1884,25,1972
13224024001,多摩市,馬引沢１丁目,1677,22,875,13,802,9,807
13224024002,多摩市,馬引沢２丁目,2345,32,1263,16,1082,16,1165
132240250,多摩市,山王下,773,17,325,5,448,12,359
13224025001,多摩市,山王下１丁目,773,17,325,5,448,12,359
13224025002,多摩市,山王下２丁目,0,0,0,0,0,0,0
132240260,多摩市,中沢,3376,59,1620,25,1756,34,1257
13224026001,多摩市,中沢１丁目,1343,25,672,10,671,15,510
13224026002,多摩市,中沢２丁目,2033,34,948,15,1085,19,747
132240270,多摩市,唐木田,2123,24,1038,11,1085,13,881
13224027001,多摩市,唐木田１丁目,2123,24,1038,11,1085,13,881
13224027002,多摩市,唐木田２丁目,0,0,0,0,0,0,0
13224027003,多摩市,唐木田３丁目,0,0,0,0,0,0,0
13225,稲城市,,87636,957,44041,446,43595,511,36533
132250010,稲城市,矢野口,17002,175,8672,70,8330,105,7672
13225001001,稲城市,矢野口,3710,35,1918,16,1792,19,1957
13225001002,稲城市,矢野口,6614,74,3420,25,3194,49,3096
13225001003,稲城市,矢野口,5302,58,2629,25,2673,33,2024
13225001004,稲城市,矢野口,1376,8,705,4,671,4,595
132250020,稲城市,東長沼,11968,142,6180,69,5788,73,5395
13225002001,稲城市,東長沼,4350,28,2221,11,2129,17,1986
13225002002,稲城市,東長沼,5380,91,2848,49,2532,42,2356
13225002003,稲城市,東長沼,2203,23,1091,9,1112,14,1041
13225002090,稲城市,東長沼,35,0,20,0,15,0,12
13225002091,稲城市,東長沼,0,0,0,0,0,0,0
132250030,稲城市,大丸,8882,107,4624,54,4258,53,4277
13225003001,稲城市,大丸,7892,87,4198,44,3694,43,3712
13225003002,稲城市,大丸,692,20,303,10,389,10,382
13225003003,稲城市,大丸,298,0,123,0,175,0,183
132250040,稲城市,百村,5010,59,2582,39,2428,20,2149
13225004000,稲城市,百村,4123,56,2132,39,1991,17,1809
13225004001,稲城市,百村,887,3,450,0,437,3,340
132250050,稲城市,坂浜,2734,27,1384,13,1350,14,1110
132250060,稲城市,平尾,11295,120,5557,51,5738,69,5122
13225006000,稲城市,平尾,873,5,414,3,459,2,252
13225006001,稲城市,平尾１丁目,2726,41,1384,22,1342,19,1176
13225006002,稲城市,平尾２丁目,3142,19,1490,5,1652,14,1220
13225006003,稲城市,平尾３丁目,4554,55,2269,21,2285,34,2474
132250070,稲城市,押立,4610,41,2390,16,2220,25,1898
132250080,稲城市,向陽台,9051,100,4379,48,4672,52,3335
13225008001,稲城市,向陽台１丁目,398,1,188,0,210,1,147
13225008002,稲城市,向陽台２丁目,773,5,374,3,399,2,236
13225008003,稲城市,向陽台３丁目,502,1,243,0,259,1,192
13225008004,稲城市,向陽台４丁目,2268,29,1104,13,1164,16,905
13225008005,稲城市,向陽台５丁目,1489,23,719,14,770,9,573
13225008006,稲城市,向陽台６丁目,3621,41,1751,18,1870,23,1282
132250090,稲城市,長峰,4488,72,2175,32,2313,40,1593
13225009001,稲城市,長峰１丁目,401,6,206,3,195,3,108
13225009002,稲城市,長峰２丁目,1057,17,534,6,523,11,359
13225009003,稲城市,長峰３丁目,3030,49,1435,23,1595,26,1126
132250100,稲城市,若葉台,12382,113,5998,53,6384,60,3871
13225010001,稲城市,若葉台１丁目,3875,31,1898,14,1977,17,1193
13225010002,稲城市,若葉台２丁目,2850,40,1408,21,1442,19,1006
13225010003,稲城市,若葉台３丁目,3164,25,1475,10,1689,15,883
13225010004,稲城市,若葉台４丁目,2493,17,1217,8,1276,9,789
132250110,稲城市,百村,214,1,100,1,114,0,111
13227,羽村市,,55833,1107,28451,482,27382,625,23451
132270010,羽村市,川崎,2045,25,1017,14,1028,11,821
13227001000,羽村市,川崎,0,0,0,0,0,0,0
13227001001,羽村市,川崎１丁目,592,9,298,6,294,3,242
13227001002,羽村市,川崎２丁目,542,10,275,7,267,3,228
13227001003,羽村市,川崎３丁目,485,4,237,1,248,3,186
13227001004,羽村市,川崎４丁目,426,2,207,0,219,2,165
132270020,羽村市,五ノ神,3910,65,1887,19,2023,46,1593
13227002000,羽村市,五ノ神,204,0,65,0,139,0,2
13227002001,羽村市,五ノ神１丁目,763,10,360,3,403,7,307
13227002002,羽村市,五ノ神２丁目,951,19,486,8,465,11,445
13227002003,羽村市,五ノ神３丁目,1184,12,580,3,604,9,481
13227002004,羽村市,五ノ神４丁目,808,24,396,5,412,19,358
132270040,羽村市,羽,594,3,273,1,321,2,169
132270080,羽村市,小作台,5935,150,3112,51,2823,99,2808
13227008001,羽村市,小作台１丁目,841,42,444,16,397,26,413
13227008002,羽村市,小作台２丁目,1376,43,800,17,576,26,771
13227008003,羽村市,小作台３丁目,1326,14,681,3,645,11,566
13227008004,羽村市,小作台４丁目,903,13,437,4,466,9,391
13227008005,羽村市,小作台５丁目,1489,38,750,11,739,27,667
132270090,羽村市,双葉町,3113,92,1571,44,1542,48,1115
13227009001,羽村市,双葉町１丁目,136,1,71,0,65,1,42
13227009002,羽村市,双葉町２丁目,2194,26,1102,10,1092,16,767
13227009003,羽村市,双葉町３丁目,783,65,398,34,385,31,306
132270100,羽村市,神明台,8970,162,4472,75,4498,87,3598
13227010001,羽村市,神明台１丁目,2249,51,1194,29,1055,22,1017
13227010002,羽村市,神明台２丁目,3003,50,1473,26,1530,24,1169
13227010003,羽村市,神明台３丁目,3011,57,1481,19,1530,38,1200
13227010004,羽村市,神明台４丁目,707,4,324,1,383,3,212
132270110,羽村市,栄町,5271,123,2912,56,2359,67,2562
13227011001,羽村市,栄町１丁目,2184,60,1154,27,1030,33,1050
13227011002,羽村市,栄町２丁目,3087,63,1758,29,1329,34,1512
13227011003,羽村市,栄町３丁目,0,0,0,0,0,0,0
132270120,羽村市,緑ケ丘,6469,156,3366,72,3103,84,2841
13227012001,羽村市,緑ケ丘１丁目,1368,27,687,10,681,17,609
13227012002,羽村市,緑ケ丘２丁目,1722,44,880,18,842,26,723
13227012003,羽村市,緑ケ丘３丁目,749,26,390,17,359,9,331
13227012004,羽村市,緑ケ丘４丁目,1204,32,670,17,534,15,541
13227012005,羽村市,緑ケ丘５丁目,1426,27,739,10,687,17,637
132270130,羽村市,玉川,1109,18,569,9,540,9,447
13227013001,羽村市,玉川１丁目,244,0,120,0,124,0,102
13227013002,羽村市,玉川２丁目,865,18,449,9,416,9,345
132270140,羽村市,富士見平,4247,165,2142,77,2105,88,1984
13227014001,羽村市,富士見平１丁目,2147,87,1059,45,1088,42,948
13227014002,羽村市,富士見平２丁目,2033,78,1051,32,982,46,1014
13227014003,羽村市,富士見平３丁目,67,0,32,0,35,0,22
132270150,羽村市,羽東,3658,67,1805,29,1853,38,1536
13227015001,羽村市,羽東１丁目,1773,43,868,21,905,22,770
13227015002,羽村市,羽東２丁目,711,16,341,7,370,9,286
13227015003,羽村市,羽東３丁目,1174,8,596,1,578,7,480
132270160,羽村市,羽中,3574,28,1814,16,1760,12,1370
13227016001,羽村市,羽中１丁目,801,7,402,4,399,3,306
13227016002,羽村市,羽中２丁目,1229,14,641,8,588,6,489
13227016003,羽村市,羽中３丁目,962,4,483,1,479,3,374
13227016004,羽村市,羽中４丁目,582,3,288,3,294,0,201
132270170,羽村市,羽加美,4113,24,2032,7,2081,17,1565
13227017001,羽村市,羽加美１丁目,1287,10,649,3,638,7,518
13227017002,羽村市,羽加美２丁目,1038,5,493,1,545,4,402
13227017003,羽村市,羽加美３丁目,1023,3,506,1,517,2,360
13227017004,羽村市,羽加美４丁目,765,6,384,2,381,4,285
132270180,羽村市,羽西,2825,29,1479,12,1346,17,1042
13227018001,羽村市,羽西１丁目,1376,24,711,11,665,13,509
13227018002,羽村市,羽西２丁目,709,5,389,1,320,4,282
13227018003,羽村市,羽西３丁目,740,0,379,0,361,0,251
132270190,羽村市,多摩川,0,0,0,0,0,0,0
13228,あきる野市,,80954,572,40218,233,40736,339,30817
132280010,あきる野市,雨間,5192,23,2605,11,2587,12,2021
13228001001,あきる野市,雨間,3107,13,1552,8,1555,5,1247
13228001002,あきる野市,雨間,2085,10,1053,3,1032,7,774
132280020,あきる野市,野辺,6450,38,3216,17,3234,21,2545
132280030,あきる野市,小川,2401,18,1236,5,1165,13,939
132280040,あきる野市,小川東,1707,33,860,13,847,20,686
13228004001,あきる野市,小川東１丁目,946,18,475,7,471,11,365
13228004002,あきる野市,小川東２丁目,607,15,305,6,302,9,248
13228004003,あきる野市,小川東３丁目,154,0,80,0,74,0,73
132280050,あきる野市,二宮,5048,54,2580,28,2468,26,2013
132280060,あきる野市,二宮東,960,6,486,1,474,5,392
13228006001,あきる野市,二宮東１丁目,528,4,266,1,262,3,218
13228006002,あきる野市,二宮東２丁目,409,2,207,0,202,2,166
13228006003,あきる野市,二宮東３丁目,23,0,13,0,10,0,8
132280070,あきる野市,平沢,1605,10,816,3,789,7,556
132280080,あきる野市,平沢東,165,9,83,5,82,4,62
132280090,あきる野市,切欠,124,0,61,0,63,0,45
132280100,あきる野市,草花,11203,113,5471,59,5732,54,4043
13228010001,あきる野市,草花,7318,94,3555,49,3763,45,2579
13228010002,あきる野市,草花,3885,19,1916,10,1969,9,1464
132280110,あきる野市,菅生,1644,5,736,1,908,4,451
132280120,あきる野市,瀬戸岡,3550,20,1757,9,1793,11,1354
132280131,あきる野市,原小宮,1062,2,526,1,536,1,326
13228013101,あきる野市,原小宮１丁目,728,2,358,1,370,1,219
13228013102,あきる野市,原小宮２丁目,334,0,168,0,166,0,107
132280132,あきる野市,原小宮,380,4,186,1,194,3,134
132280140,あきる野市,引田,3835,18,1911,4,1924,14,1461
132280150,あきる野市,渕上,1455,7,748,4,707,3,553
132280160,あきる野市,上代継,1062,3,532,0,530,3,415
132280170,あきる野市,下代継,1636,14,795,2,841,12,611
132280180,あきる野市,牛沼,2218,25,1126,4,1092,21,895
132280190,あきる野市,油平,2351,17,1123,3,1228,14,973
132280200,あきる野市,秋川,3420,47,1707,19,1713,28,1559
13228020001,あきる野市,秋川１丁目,244,5,115,2,129,3,122
13228020002,あきる野市,秋川２丁目,463,4,220,3,243,1,211
13228020003,あきる野市,秋川３丁目,540,13,279,6,261,7,235
13228020004,あきる野市,秋川４丁目,704,9,368,5,336,4,360
13228020005,あきる野市,秋川５丁目,816,11,415,3,401,8,376
13228020006,あきる野市,秋川６丁目,653,5,310,0,343,5,255
132280210,あきる野市,山田,2836,13,1395,5,1441,8,1053
132280220,あきる野市,上ノ台,27,0,15,0,12,0,11
132280230,あきる野市,網代,387,5,162,3,225,2,95
132280240,あきる野市,伊奈,5422,24,2679,5,2743,19,2153
132280250,あきる野市,横沢,199,0,106,0,93,0,76
132280260,あきる野市,三内,1279,5,592,4,687,1,383
132280270,あきる野市,五日市,2826,3,1415,1,1411,2,1092
132280280,あきる野市,小中野,971,0,493,0,478,0,366
132280290,あきる野市,小和田,373,0,189,0,184,0,134
132280300,あきる野市,留原,1647,8,829,5,818,3,606
132280310,あきる野市,高尾,1011,4,485,2,526,2,364
132280320,あきる野市,舘谷,1178,5,584,3,594,2,439
132280330,あきる野市,入野,1381,7,691,3,690,4,492
132280340,あきる野市,深沢,66,0,34,0,32,0,29
132280350,あきる野市,戸倉,735,2,364,0,371,2,271
132280360,あきる野市,乙津,513,4,261,1,252,3,210
132280370,あきる野市,養沢,281,3,150,1,131,2,115
132280380,あきる野市,小峰台,0,0,0,0,0,0,0
132280390,あきる野市,秋留,2181,23,1122,10,1059,13,829
13228039001,あきる野市,秋留１丁目,750,22,388,10,362,12,355
13228039002,あきる野市,秋留２丁目,322,1,165,0,157,1,110
13228039003,あきる野市,秋留３丁目,362,0,184,0,178,0,115
13228039004,あきる野市,秋留４丁目,385,0,207,0,178,0,129
13228039005,あきる野市,秋留５丁目,362,0,178,0,184,0,120
132280400,あきる野市,舘谷台,7,X,4,X,3,X,6
132280410,あきる野市,平沢西,166,0,87,0,79,0,59
13229,西東京市,,200012,3007,97830,1441,102182,1566,89734
132290010,西東京市,新町,8987,136,4309,71,4678,65,3951
13229001001,西東京市,新町１丁目,2309,47,1050,27,1259,20,1057
13229001002,西東京市,新町２丁目,690,6,336,1,354,5,319
13229001003,西東京市,新町３丁目,1000,24,522,18,478,6,412
13229001004,西東京市,新町４丁目,1224,17,602,7,622,10,528
13229001005,西東京市,新町５丁目,2544,31,1192,14,1352,17,1138
13229001006,西東京市,新町６丁目,1220,11,607,4,613,7,497
132290020,西東京市,柳沢,12147,241,5747,107,6400,134,5477
13229002001,西東京市,柳沢１丁目,2021,43,943,18,1078,25,1004
13229002002,西東京市,柳沢２丁目,3103,62,1462,25,1641,37,1304
13229002003,西東京市,柳沢３丁目,2102,35,1027,21,1075,14,966
13229002004,西東京市,柳沢４丁目,520,8,204,4,316,4,146
13229002005,西東京市,柳沢５丁目,2791,57,1355,24,1436,33,1244
13229002006,西東京市,柳沢６丁目,1610,36,756,15,854,21,813
132290030,西東京市,東伏見,5575,108,2878,53,2697,55,2701
13229003001,西東京市,東伏見１丁目,340,3,181,1,159,2,190
13229003002,西東京市,東伏見２丁目,1050,20,487,7,563,13,552
13229003003,西東京市,東伏見３丁目,1098,36,672,28,426,8,378
13229003004,西東京市,東伏見４丁目,1170,24,553,7,617,17,589
13229003005,西東京市,東伏見５丁目,1337,12,685,3,652,9,698
13229003006,西東京市,東伏見６丁目,580,13,300,7,280,6,294
132290040,西東京市,保谷町,12305,216,6027,102,6278,114,5982
13229004001,西東京市,保谷町１丁目,1515,17,731,6,784,11,623
13229004002,西東京市,保谷町２丁目,1028,35,519,20,509,15,534
13229004003,西東京市,保谷町３丁目,2391,33,1175,11,1216,22,1358
13229004004,西東京市,保谷町４丁目,1449,24,697,11,752,13,695
13229004005,西東京市,保谷町５丁目,2763,51,1337,26,1426,25,1265
13229004006,西東京市,保谷町６丁目,3159,56,1568,28,1591,28,1507
132290050,西東京市,富士町,11423,279,5760,168,5663,111,5451
13229005001,西東京市,富士町１丁目,3167,118,1600,74,1567,44,1412
13229005002,西東京市,富士町２丁目,1753,12,851,6,902,6,748
13229005003,西東京市,富士町３丁目,1004,13,483,9,521,4,489
13229005004,西東京市,富士町４丁目,3261,98,1705,59,1556,39,1584
13229005005,西東京市,富士町５丁目,1105,25,555,14,550,11,597
13229005006,西東京市,富士町６丁目,1133,13,566,6,567,7,621
132290060,西東京市,中町,6776,74,3317,40,3459,34,2787
13229006001,西東京市,中町１丁目,764,2,380,2,384,0,335
13229006002,西東京市,中町２丁目,922,15,460,8,462,7,439
13229006003,西東京市,中町３丁目,1147,15,573,8,574,7,457
13229006004,西東京市,中町４丁目,1279,7,617,2,662,5,485
13229006005,西東京市,中町５丁目,1553,31,774,18,779,13,636
13229006006,西東京市,中町６丁目,1111,4,513,2,598,2,435
132290070,西東京市,東町,7702,123,3720,48,3982,75,3655
13229007001,西東京市,東町１丁目,723,15,366,7,357,8,379
13229007002,西東京市,東町２丁目,1426,9,672,4,754,5,734
13229007003,西東京市,東町３丁目,1446,23,659,15,787,8,755
13229007004,西東京市,東町４丁目,1585,19,758,8,827,11,812
13229007005,西東京市,東町５丁目,1264,48,665,11,599,37,516
13229007006,西東京市,東町６丁目,1258,9,600,3,658,6,459
132290080,西東京市,泉町,8563,99,4251,55,4312,44,3569
13229008001,西東京市,泉町１丁目,1783,31,882,17,901,14,737
13229008002,西東京市,泉町２丁目,1979,16,962,6,1017,10,789
13229008003,西東京市,泉町３丁目,1009,22,541,17,468,5,446
13229008004,西東京市,泉町４丁目,704,3,344,1,360,2,301
13229008005,西東京市,泉町５丁目,1556,14,763,8,793,6,674
13229008006,西東京市,泉町６丁目,1532,13,759,6,773,7,622
132290090,西東京市,住吉町,7019,73,3559,41,3460,32,3080
13229009001,西東京市,住吉町１丁目,1761,16,893,9,868,7,735
13229009002,西東京市,住吉町２丁目,811,3,394,3,417,0,398
13229009003,西東京市,住吉町３丁目,1777,34,868,16,909,18,822
13229009004,西東京市,住吉町４丁目,1147,6,597,5,550,1,531
13229009005,西東京市,住吉町５丁目,553,4,283,0,270,4,225
13229009006,西東京市,住吉町６丁目,970,10,524,8,446,2,369
132290100,西東京市,ひばりが丘,8046,115,3716,53,4330,62,3500
13229010001,西東京市,ひばりが丘１丁目,1933,26,920,12,1013,14,985
13229010002,西東京市,ひばりが丘２丁目,2545,27,1205,11,1340,16,1047
13229010003,西東京市,ひばりが丘３丁目,1714,41,707,21,1007,20,797
13229010004,西東京市,ひばりが丘４丁目,1854,21,884,9,970,12,671
132290110,西東京市,ひばりが丘北,4237,71,2080,32,2157,39,2241
13229011001,西東京市,ひばりが丘北１丁目,1137,11,547,5,590,6,523
13229011002,西東京市,ひばりが丘北２丁目,1061,18,512,7,549,11,519
13229011003,西東京市,ひばりが丘北３丁目,1045,23,528,13,517,10,638
13229011004,西東京市,ひばりが丘北４丁目,994,19,493,7,501,12,561
132290120,西東京市,栄町,4033,28,2018,20,2015,8,1472
13229012001,西東京市,栄町１丁目,1905,7,964,5,941,2,691
13229012002,西東京市,栄町２丁目,1369,16,712,13,657,3,521
13229012003,西東京市,栄町３丁目,759,5,342,2,417,3,260
132290130,西東京市,北町,4945,37,2426,16,2519,21,1987
13229013001,西東京市,北町１丁目,554,5,284,3,270,2,224
13229013002,西東京市,北町２丁目,1520,12,757,5,763,7,605
13229013003,西東京市,北町３丁目,871,3,418,1,453,2,333
13229013004,西東京市,北町４丁目,595,3,285,0,310,3,221
13229013005,西東京市,北町５丁目,1112,4,544,1,568,3,456
13229013006,西東京市,北町６丁目,293,10,138,6,155,4,148
132290140,西東京市,下保谷,8246,77,3886,35,4360,42,3871
13229014001,西東京市,下保谷１丁目,863,2,407,0,456,2,356
13229014002,西東京市,下保谷２丁目,1813,12,856,5,957,7,850
13229014003,西東京市,下保谷３丁目,2020,19,945,11,1075,8,856
13229014004,西東京市,下保谷４丁目,1455,8,685,4,770,4,804
13229014005,西東京市,下保谷５丁目,2095,36,993,15,1102,21,1005
132290150,西東京市,田無町,13749,297,6684,109,7065,188,7076
13229015001,西東京市,田無町１丁目,1633,29,819,13,814,16,832
13229015002,西東京市,田無町２丁目,2038,50,953,21,1085,29,1039
13229015003,西東京市,田無町３丁目,1707,66,823,26,884,40,996
13229015004,西東京市,田無町４丁目,2210,30,1097,11,1113,19,1266
13229015005,西東京市,田無町５丁目,1819,58,851,8,968,50,833
13229015006,西東京市,田無町６丁目,1718,24,879,14,839,10,831
13229015007,西東京市,田無町７丁目,2624,40,1262,16,1362,24,1279
132290160,西東京市,南町,13078,215,6408,116,6670,99,6215
13229016001,西東京市,南町１丁目,1897,73,977,58,920,15,1028
13229016002,西東京市,南町２丁目,2114,20,1074,9,1040,11,986
13229016003,西東京市,南町３丁目,2972,36,1398,16,1574,20,1335
13229016004,西東京市,南町４丁目,2064,42,995,12,1069,30,1059
13229016005,西東京市,南町５丁目,1899,27,911,12,988,15,933
13229016006,西東京市,南町６丁目,2132,17,1053,9,1079,8,874
132290170,西東京市,西原町,6966,92,3407,61,3559,31,3116
13229017001,西東京市,西原町１丁目,1063,18,486,7,577,11,522
13229017002,西東京市,西原町２丁目,634,5,309,3,325,2,239
13229017003,西東京市,西原町３丁目,1517,18,748,7,769,11,716
13229017004,西東京市,西原町４丁目,2650,8,1245,4,1405,4,1096
13229017005,西東京市,西原町５丁目,1102,43,619,40,483,3,543
132290180,西東京市,緑町,3934,56,1877,26,2057,30,1722
13229018001,西東京市,緑町１丁目,1221,27,586,10,635,17,577
13229018002,西東京市,緑町２丁目,1580,12,780,7,800,5,630
13229018003,西東京市,緑町３丁目,1133,17,511,9,622,8,515
132290200,西東京市,谷戸町,13493,194,6518,78,6975,116,5608
13229020001,西東京市,谷戸町１丁目,2846,54,1392,22,1454,32,1262
13229020002,西東京市,谷戸町２丁目,7069,94,3401,43,3668,51,2668
13229020003,西東京市,谷戸町３丁目,3578,46,1725,13,1853,33,1678
132290210,西東京市,北原町,4300,51,2196,29,2104,22,2063
13229021001,西東京市,北原町１丁目,2133,21,1028,7,1105,14,991
13229021002,西東京市,北原町２丁目,1231,13,625,9,606,4,569
13229021003,西東京市,北原町３丁目,936,17,543,13,393,4,503
132290220,西東京市,向台町,14940,177,7312,73,7628,104,5947
13229022001,西東京市,向台町１丁目,2296,9,1139,6,1157,3,988
13229022002,西東京市,向台町２丁目,2035,9,985,3,1050,6,798
13229022003,西東京市,向台町３丁目,4547,90,2195,32,2352,58,1546
13229022004,西東京市,向台町４丁目,3577,52,1760,21,1817,31,1599
13229022005,西東京市,向台町５丁目,837,6,418,4,419,2,313
13229022006,西東京市,向台町６丁目,1648,11,815,7,833,4,703
132290230,西東京市,芝久保町,19548,248,9734,108,9814,140,8263
13229023001,西東京市,芝久保町１丁目,5726,65,2865,25,2861,40,2284
13229023002,西東京市,芝久保町２丁目,4297,85,2146,45,2151,40,1832
13229023003,西東京市,芝久保町３丁目,3489,59,1749,24,1740,35,1576
13229023004,西東京市,芝久保町４丁目,3719,22,1812,9,1907,13,1593
13229023005,西東京市,芝久保町５丁目,2317,17,1162,5,1155,12,978
13303,西多摩郡瑞穂町,,33445,565,16951,281,16494,284,13192
133030010,西多摩郡瑞穂町,大字殿ケ谷,2897,29,1515,14,1382,15,1156
133030020,西多摩郡瑞穂町,大字石畑,3024,26,1556,7,1468,19,1179
133030030,西多摩郡瑞穂町,大字箱根ヶ崎,6585,83,3324,38,3261,45,2702
13303003001,西多摩郡瑞穂町,大字箱根ヶ崎,5906,65,3019,29,2887,36,2533
13303003002,西多摩郡瑞穂町,大字箱根ヶ崎,679,18,305,9,374,9,169
133030040,西多摩郡瑞穂町,大字長岡下師岡,38,0,17,0,21,0,14
133030050,西多摩郡瑞穂町,大字長岡長谷部,846,3,394,1,452,2,241
133030060,西多摩郡瑞穂町,大字二本木,2526,15,1260,6,1266,9,844
133030070,西多摩郡瑞穂町,大字駒形富士山,1728,43,926,32,802,11,689
133030080,西多摩郡瑞穂町,大字高根,1723,24,890,14,833,10,661
133030090,西多摩郡瑞穂町,大字富士山栗原新田,252,1,129,1,123,0,91
133030100,西多摩郡瑞穂町,大字武蔵,596,14,315,6,281,8,257
133030110,西多摩郡瑞穂町,大字長岡藤橋,0,0,0,0,0,0,0
133030120,西多摩郡瑞穂町,箱根ヶ崎東松原,996,20,502,10,494,10,410
133030130,西多摩郡瑞穂町,箱根ヶ崎西松原,2427,44,1252,20,1175,24,954
133030140,西多摩郡瑞穂町,南平,1938,48,1045,31,893,17,843
13303014001,西多摩郡瑞穂町,南平一丁目,129,7,96,7,33,0,91
13303014002,西多摩郡瑞穂町,南平二丁目,1809,41,949,24,860,17,752
133030150,西多摩郡瑞穂町,長岡,3524,71,1808,47,1716,24,1349
13303015001,西多摩郡瑞穂町,長岡一丁目,1943,44,994,31,949,13,731
13303015002,西多摩郡瑞穂町,長岡二丁目,0,0,0,0,0,0,0
13303015003,西多摩郡瑞穂町,長岡三丁目,24,0,12,0,12,0,12
13303015004,西多摩郡瑞穂町,長岡四丁目,1557,27,802,16,755,11,606
133030160,西多摩郡瑞穂町,むさし野,4345,144,2018,54,2327,90,1802
13303016001,西多摩郡瑞穂町,むさし野一丁目,2192,87,948,26,1244,61,913
13303016002,西多摩郡瑞穂町,むさし野二丁目,2031,53,1005,26,1026,27,843
13303016003,西多摩郡瑞穂町,むさし野三丁目,122,4,65,2,57,2,46
133030170,西多摩郡瑞穂町,横田基地,0,0,0,0,0,0,0
13305,西多摩郡日の出町,,17446,75,8485,25,8961,50,5800
133050010,西多摩郡日の出町,大字平井,12061,52,5916,21,6145,31,4103
13305001001,西多摩郡日の出町,大字平井谷の入,232,0,125,0,107,0,87
13305001002,西多摩郡日の出町,大字平井宮本・足下田,690,4,290,2,400,2,156
13305001003,西多摩郡日の出町,大字平井谷戸,851,10,349,6,502,4,155
13305001004,西多摩郡日の出町,大字平井塩田・狩宿・中野,1117,1,572,0,545,1,361
13305001005,西多摩郡日の出町,大字平井本宿,1529,6,761,3,768,3,559
13305001006,西多摩郡日の出町,大字平井道場,841,5,418,2,423,3,307
13305001007,西多摩郡日の出町,大字平井三吉野１,1457,6,749,2,708,4,453
13305001008,西多摩郡日の出町,大字平井三吉野２,1503,7,748,3,755,4,554
13305001009,西多摩郡日の出町,大字平井三吉野３,1341,4,682,2,659,2,514
13305001010,西多摩郡日の出町,大字平井三吉野４,246,1,104,0,142,1,50
13305001011,西多摩郡日の出町,大字平井中野３,487,2,230,0,257,2,192
13305001012,西多摩郡日の出町,大字平井中野２,513,3,259,1,254,2,212
13305001013,西多摩郡日の出町,大字平井中野１,568,1,282,0,286,1,234
13305001014,西多摩郡日の出町,大字平井三吉野５,239,0,119,0,120,0,98
13305001015,西多摩郡日の出町,大字平井三吉野６,447,2,228,0,219,2,171
13305001016,西多摩郡日の出町,大字平井肝要・松尾・三ツ沢,0,0,0,0,0,0,0
133050020,西多摩郡日の出町,大字大久野,5385,23,2569,4,2816,19,1697
13305002001,西多摩郡日の出町,大字大久野落合,886,6,399,1,487,5,245
13305002002,西多摩郡日の出町,大字大久野萱窪,1016,3,502,1,514,2,342
13305002003,西多摩郡日の出町,大字大久野羽生,460,2,208,0,252,2,140
13305002004,西多摩郡日の出町,大字大久野幸神,662,1,305,0,357,1,198
13305002005,西多摩郡日の出町,大字大久野新井,487,6,236,2,251,4,173
13305002006,西多摩郡日の出町,大字大久野岩井,59,0,32,0,27,0,23
13305002007,西多摩郡日の出町,大字大久野細尾,286,2,121,0,165,2,69
13305002008,西多摩郡日の出町,大字大久野肝要・松尾・三ツ沢,203,0,110,0,93,0,67
13305002009,西多摩郡日の出町,大字大久野長井,139,0,72,0,67,0,44
13305002010,西多摩郡日の出町,大字大久野水口,276,1,132,0,144,1,62
13305002011,西多摩郡日の出町,大字大久野坊平・北原・坂本,615,2,311,0,304,2,226
13305002012,西多摩郡日の出町,大字大久野玉の内,296,0,141,0,155,0,108
13307,西多摩郡檜原村,,2209,12,1081,3,1128,9,839
133070010,西多摩郡檜原村,,2209,12,1081,3,1128,9,839
13307001001,西多摩郡檜原村,下元郷,131,0,66,0,65,0,58
13307001002,西多摩郡檜原村,上元郷,223,3,104,0,119,3,77
13307001003,西多摩郡檜原村,本宿,202,0,111,0,91,0,76
13307001004,西多摩郡檜原村,南郷,312,0,157,0,155,0,140
13307001005,西多摩郡檜原村,人里,293,5,121,2,172,3,82
13307001006,西多摩郡檜原村,数馬,104,0,55,0,49,0,44
13307001007,西多摩郡檜原村,三都郷,271,2,143,1,128,1,106
13307001008,西多摩郡檜原村,大嶽,0,0,0,0,0,0,0
13307001009,西多摩郡檜原村,神戸,142,0,75,0,67,0,53
13307001010,西多摩郡檜原村,小沢,318,2,139,0,179,2,101
13307001011,西多摩郡檜原村,樋里,150,0,77,0,73,0,70
13307001012,西多摩郡檜原村,藤原,38,0,21,0,17,0,22
13307001013,西多摩郡檜原村,倉掛,25,0,12,0,13,0,10
13308,西多摩郡奥多摩町,,5234,25,2579,13,2655,12,2045
133080010,西多摩郡奥多摩町,町丁字コード0010の計,2618,12,1256,4,1362,8,1003
13308001001,西多摩郡奥多摩町,川井,411,4,207,2,204,2,169
13308001002,西多摩郡奥多摩町,大丹波,361,1,196,1,165,0,144
13308001003,西多摩郡奥多摩町,梅沢,121,1,53,0,68,1,52
13308001004,西多摩郡奥多摩町,丹三郎,272,2,108,0,164,2,72
13308001005,西多摩郡奥多摩町,小丹波,773,4,388,1,385,3,315
13308001006,西多摩郡奥多摩町,棚沢,467,0,232,0,235,0,200
13308001007,西多摩郡奥多摩町,白丸,213,0,72,0,141,0,51
133080020,西多摩郡奥多摩町,町丁字コード0020の計,2398,12,1205,8,1193,4,930
13308002001,西多摩郡奥多摩町,氷川,406,2,204,1,202,1,180
13308002002,西多摩郡奥多摩町,氷川,329,1,164,1,165,0,107
13308002003,西多摩郡奥多摩町,氷川,183,0,100,0,83,0,82
13308002004,西多摩郡奥多摩町,氷川,203,1,90,0,113,1,89
13308002005,西多摩郡奥多摩町,氷川,329,2,170,1,159,1,149
13308002006,西多摩郡奥多摩町,氷川,50,0,25,0,25,0,28
13308002007,西多摩郡奥多摩町,日原,94,0,48,0,46,0,55
13308002008,西多摩郡奥多摩町,海沢,635,6,321,5,314,1,156
13308002009,西多摩郡奥多摩町,境,106,0,55,0,51,0,54
13308002010,西多摩郡奥多摩町,境,63,0,28,0,35,0,30
133080030,西多摩郡奥多摩町,町丁字コード0030の計,218,1,118,1,100,0,112
13308003001,西多摩郡奥多摩町,河内,63,0,37,0,26,0,33
13308003002,西多摩郡奥多摩町,川野,45,0,22,0,23,0,20
13308003003,西多摩郡奥多摩町,留浦,21,1,14,1,7,0,11
13308003004,西多摩郡奥多摩町,留浦,89,0,45,0,44,0,48
13308003005,西多摩郡奥多摩町,原,0,0,0,0,0,0,0
13361,大島支庁大島町,,7884,85,4031,70,3853,15,3947
133610010,大島支庁大島町,元町,2450,9,1245,5,1205,4,1277
13361001001,大島支庁大島町,元町１丁目,293,2,142,0,151,2,162
13361001002,大島支庁大島町,元町２丁目,224,0,118,0,106,0,143
13361001003,大島支庁大島町,元町３丁目,288,0,145,0,143,0,148
13361001004,大島支庁大島町,元町４丁目,323,1,153,0,170,1,181
13361001005,大島支庁大島町,元町字和泉,36,1,18,0,18,1,20
13361001006,大島支庁大島町,元町字神明,2,X,1,X,1,X,1
13361001007,大島支庁大島町,元町字新込,47,0,26,0,21,0,24
13361001008,大島支庁大島町,元町字八重の水,80,0,38,0,42,0,32
13361001009,大島支庁大島町,元町字ホチマツ,2,X,1,X,1,X,1
13361001010,大島支庁大島町,元町字小清水,45,0,22,0,23,0,23
13361001011,大島支庁大島町,元町字大津,18,0,9,0,9,0,10
13361001012,大島支庁大島町,元町字黒まま,17,X,13,X,4,X,12
13361001013,大島支庁大島町,元町字馬の背,309,0,174,0,135,0,151
13361001014,大島支庁大島町,元町字水溜,70,0,34,0,36,0,41
13361001015,大島支庁大島町,元町字仲野,212,1,110,1,102,0,97
13361001016,大島支庁大島町,元町字オンダシ,6,X,2,X,4,X,3
13361001017,大島支庁大島町,元町字五輪,16,0,7,0,9,0,5
13361001018,大島支庁大島町,元町字金砂,3,X,2,X,1,X,1
13361001019,大島支庁大島町,元町字出払,98,4,51,4,47,0,47
13361001020,大島支庁大島町,元町字吉谷,3,X,0,X,3,X,3
13361001021,大島支庁大島町,元町字家の上,262,0,127,0,135,0,121
13361001022,大島支庁大島町,元町字丸塚,5,X,3,X,2,X,2
13361001023,大島支庁大島町,元町字神達,8,X,4,X,4,X,4
13361001024,大島支庁大島町,元町字大金砂,12,0,4,0,8,0,3
13361001025,大島支庁大島町,元町字神田屋敷,21,0,13,0,8,0,15
13361001026,大島支庁大島町,元町字金つぼ,10,0,4,0,6,0,9
13361001027,大島支庁大島町,元町字みたき堂,6,X,4,X,2,X,4
13361001028,大島支庁大島町,元町字大昇,32,0,19,0,13,0,13
13361001029,大島支庁大島町,元町字木橋の尾,0,0,0,0,0,0,0
13361001030,大島支庁大島町,元町字橋の沢,2,X,1,X,1,X,1
133610020,大島支庁大島町,元町,1384,3,653,2,731,1,642
13361002001,大島支庁大島町,元町字北の山,557,1,274,1,283,0,267
13361002002,大島支庁大島町,元町字野地,60,1,25,0,35,1,36
13361002003,大島支庁大島町,元町字風待,94,0,41,0,53,0,54
13361002004,大島支庁大島町,元町字アイノウ,1,X,1,X,0,X,1
13361002005,大島支庁大島町,元町字仲中,14,0,10,0,4,0,8
13361002006,大島支庁大島町,元町字上山,34,1,20,1,14,0,20
13361002007,大島支庁大島町,元町字佐吾エ門野地,47,0,23,0,24,0,30
13361002008,大島支庁大島町,元町字水汲沢,0,0,0,0,0,0,0
13361002009,大島支庁大島町,元町字北野,84,0,45,0,39,0,34
13361002010,大島支庁大島町,元町字赤禿,96,0,53,0,43,0,47
13361002011,大島支庁大島町,元町字地の岡,360,0,143,0,217,0,129
13361002012,大島支庁大島町,元町字津倍付,31,0,16,0,15,0,13
13361002013,大島支庁大島町,元町字鼠つど,6,X,2,X,4,X,3
133610030,大島支庁大島町,岡田,825,7,402,3,423,4,408
13361003000,大島支庁大島町,岡田,196,6,104,3,92,3,111
13361003001,大島支庁大島町,岡田字新開,331,0,155,0,176,0,157
13361003002,大島支庁大島町,岡田字平浜,4,X,2,X,2,X,2
13361003003,大島支庁大島町,岡田字北野,14,0,8,0,6,0,7
13361003004,大島支庁大島町,岡田字小堀,62,0,30,0,32,0,30
13361003005,大島支庁大島町,岡田字橋の本,26,0,12,0,14,0,14
13361003006,大島支庁大島町,岡田字沢立,46,1,19,0,27,1,25
13361003007,大島支庁大島町,岡田字笹郷,54,0,26,0,28,0,25
13361003008,大島支庁大島町,岡田字長坂,10,0,6,0,4,0,5
13361003009,大島支庁大島町,岡田字大久保,2,X,1,X,1,X,1
13361003010,大島支庁大島町,岡田字助田,47,0,23,0,24,0,16
13361003011,大島支庁大島町,岡田字榎戸,21,0,9,0,12,0,7
13361003012,大島支庁大島町,岡田字川の道,9,0,6,0,3,0,7
13361003013,大島支庁大島町,岡田字七間沢,3,X,1,X,2,X,1
133610040,大島支庁大島町,泉津,364,1,171,0,193,1,198
13361004000,大島支庁大島町,泉津,109,0,46,0,63,0,61
13361004001,大島支庁大島町,泉津字秋の原,21,0,12,0,9,0,12
13361004002,大島支庁大島町,泉津字川の原,17,0,11,0,6,0,10
13361004003,大島支庁大島町,泉津字大坂,4,X,3,X,1,X,3
13361004004,大島支庁大島町,泉津字腰の下,14,0,7,0,7,0,7
13361004006,大島支庁大島町,泉津字道下,19,0,9,0,10,0,9
13361004007,大島支庁大島町,泉津字不重,55,1,22,0,33,1,28
13361004008,大島支庁大島町,泉津字木出場,5,X,3,X,2,X,2
13361004009,大島支庁大島町,泉津字伊東無,12,0,5,0,7,0,8
13361004010,大島支庁大島町,泉津字込内,44,0,29,0,15,0,23
13361004011,大島支庁大島町,泉津字峠,7,0,2,0,5,0,5
13361004012,大島支庁大島町,泉津字波牛,6,X,2,X,4,X,4
13361004013,大島支庁大島町,泉津字木積場,32,0,14,0,18,0,17
13361004014,大島支庁大島町,泉津字福重,10,X,4,X,6,X,4
13361004015,大島支庁大島町,泉津字原野,0,0,0,0,0,0,0
13361004016,大島支庁大島町,泉津字河内,9,X,2,X,7,X,5
133610050,大島支庁大島町,波浮港,674,16,402,15,272,1,267
133610060,大島支庁大島町,差木地,1687,47,913,43,774,4,876
13361006000,大島支庁大島町,差木地,1020,3,545,1,475,2,487
13361006001,大島支庁大島町,差木地字クダッチ,667,44,368,42,299,2,389
13361006002,大島支庁大島町,差木地字奥山,0,0,0,0,0,0,0
133610070,大島支庁大島町,野増,500,2,245,2,255,0,279
13361007000,大島支庁大島町,野増,203,0,97,0,106,0,118
13361007001,大島支庁大島町,野増字間伏,140,1,62,1,78,0,77
13361007002,大島支庁大島町,野増字大石,0,0,0,0,0,0,0
13361007003,大島支庁大島町,野増字大宮,18,0,11,0,7,0,10
13361007004,大島支庁大島町,野増字のんなか,4,X,2,X,2,X,2
13361007005,大島支庁大島町,野増字橋の沢,4,X,2,X,2,X,2
13361007006,大島支庁大島町,野増字マツコウ,3,X,1,X,2,X,2
13361007007,大島支庁大島町,野増字ヲクノクボ,5,X,2,X,3,X,1
13361007008,大島支庁大島町,野増字ワダ,6,X,2,X,4,X,3
13361007009,大島支庁大島町,野増字アジコノナホウ,0,0,0,0,0,0,0
13361007010,大島支庁大島町,野増字エンシュウアイノウ,12,0,7,0,5,0,5
13361007011,大島支庁大島町,野増字ゼンニョウ,11,0,11,0,0,0,10
13361007012,大島支庁大島町,野増字王若,21,0,9,0,12,0,7
13361007013,大島支庁大島町,野増字ヲワナ,41,0,24,0,17,0,21
13361007014,大島支庁大島町,野増字ツヅコ沢,2,X,1,X,1,X,1
13361007015,大島支庁大島町,野増字王の上,1,X,1,X,0,X,1
13361007016,大島支庁大島町,野増字下平,2,X,1,X,1,X,1
13361007017,大島支庁大島町,野増字下センバ,0,0,0,0,0,0,0
13361007018,大島支庁大島町,野増字ツワイ,25,1,11,1,14,0,17
13361007019,大島支庁大島町,野増字前世,2,X,1,X,1,X,1
13361007020,大島支庁大島町,野増字上山,0,0,0,0,0,0,0
13362,大島支庁利島村,,337,1,191,0,146,1,194
133620010,大島支庁利島村,利島村,337,1,191,0,146,1,194
13363,大島支庁新島村,,2749,10,1344,4,1405,6,1261
133630011,大島支庁新島村,本村,1759,7,856,3,903,4,784
13363001101,大島支庁新島村,本村１丁目,251,1,121,0,130,1,98
13363001102,大島支庁新島村,本村２丁目,270,1,124,0,146,1,116
13363001103,大島支庁新島村,本村３丁目,271,0,126,0,145,0,128
13363001104,大島支庁新島村,本村４丁目,395,1,191,0,204,1,183
13363001105,大島支庁新島村,本村５丁目,322,4,165,3,157,1,141
13363001106,大島支庁新島村,本村６丁目,250,0,129,0,121,0,118
133630012,大島支庁新島村,本村,166,0,89,0,77,0,75
13363001200,大島支庁新島村,本村字川原,45,0,37,0,8,0,34
13363001207,大島支庁新島村,本村字向山,81,0,29,0,52,0,24
13363001209,大島支庁新島村,本村字阿土山,0,0,0,0,0,0,0
13363001210,大島支庁新島村,本村字宮塚山,40,0,23,0,17,0,17
133630020,大島支庁新島村,式根島,519,0,246,0,273,0,262
133630030,大島支庁新島村,若郷,305,3,153,1,152,2,140
13363003000,大島支庁新島村,若郷,291,3,145,1,146,2,136
13363003001,大島支庁新島村,若郷字野原霞山,14,0,8,0,6,0,4
13363003002,大島支庁新島村,若郷字新島山,0,0,0,0,0,0,0
13363003003,大島支庁新島村,若郷字木戸上,0,0,0,0,0,0,0
13363003004,大島支庁新島村,若郷字山神北東,0,0,0,0,0,0,0
13363003005,大島支庁新島村,若郷字野原淡井道南,0,0,0,0,0,0,0
13363003006,大島支庁新島村,若郷字渡世山,0,0,0,0,0,0,0
13363003007,大島支庁新島村,若郷字久田巻,0,0,0,0,0,0,0
133630040,大島支庁新島村,鵜渡根島,0,0,0,0,0,0,0
133630050,大島支庁新島村,地内島,0,0,0,0,0,0,0
133630060,大島支庁新島村,早島,0,0,0,0,0,0,0
13364,大島支庁神津島村,,1891,2,969,1,922,1,791
133640010,大島支庁神津島村,,1891,2,969,1,922,1,791
13364001001,大島支庁神津島村,,1784,2,915,1,869,1,752
13364001002,大島支庁神津島村,高嶺,1,X,1,X,0,X,1
13364001003,大島支庁神津島村,沢尻,49,0,20,0,29,0,5
13364001004,大島支庁神津島村,錆崎,3,X,1,X,2,X,2
13364001005,大島支庁神津島村,滝川,5,X,3,X,2,X,3
13364001006,大島支庁神津島村,鍛冶山,21,0,14,0,7,0,15
13364001007,大島支庁神津島村,鉄砲場,5,X,1,X,4,X,3
13364001008,大島支庁神津島村,高処山,0,0,0,0,0,0,0
13364001009,大島支庁神津島村,面房,3,X,2,X,1,X,2
13364001010,大島支庁神津島村,向山,3,X,2,X,1,X,2
13364001011,大島支庁神津島村,山川,7,0,5,0,2,0,1
13364001012,大島支庁神津島村,洞沢,0,0,0,0,0,0,0
13364001013,大島支庁神津島村,秩父山,6,X,4,X,2,X,2
13364001014,大島支庁神津島村,三浦,3,X,1,X,2,X,2
13364001015,大島支庁神津島村,大沢,1,X,0,X,1,X,1
13364001016,大島支庁神津島村,天上山、多幸、等,0,0,0,0,0,0,0
13364001017,大島支庁神津島村,恩馳島,0,0,0,0,0,0,0
13364001018,大島支庁神津島村,祇苗島,0,0,0,0,0,0,0
13364001019,大島支庁神津島村,金長、等,0,0,0,0,0,0,0
13381,三宅支庁三宅村,,2482,41,1350,10,1132,31,1483
133810010,三宅支庁三宅村,坪田,569,20,306,8,263,12,350
133810020,三宅支庁三宅村,阿古,877,10,475,2,402,8,496
133810030,三宅支庁三宅村,伊ヶ谷,141,2,78,0,63,2,83
133810040,三宅支庁三宅村,伊豆,418,2,232,0,186,2,267
133810050,三宅支庁三宅村,神着,477,7,259,0,218,7,287
133810060,三宅支庁三宅村,雄山,0,0,0,0,0,0,0
13382,三宅支庁御蔵島村,,335,1,189,0,146,1,194
133820010,三宅支庁御蔵島村,御蔵島村,335,1,189,0,146,1,194
13401,八丈支庁八丈町,,7613,98,3785,11,3828,87,3913
134010010,八丈支庁八丈町,三根,3600,65,1798,9,1802,56,1897
134010020,八丈支庁八丈町,大賀郷,2490,24,1234,2,1256,22,1228
134010030,八丈支庁八丈町,樫立,525,2,263,0,262,2,274
134010040,八丈支庁八丈町,中之郷,680,5,334,0,346,5,330
134010050,八丈支庁八丈町,末吉,318,2,156,0,162,2,184
134010060,八丈支庁八丈町,八丈小島,0,0,0,0,0,0,0
13402,八丈支庁青ヶ島村,,178,1,107,0,71,1,125
134020010,八丈支庁青ヶ島村,青ケ島村,178,1,107,0,71,1,125
134020020,八丈支庁青ヶ島村,,0,0,0,0,0,0,0
13421,小笠原支庁小笠原村,,3022,18,1893,9,1129,9,1517
134210010,小笠原支庁小笠原村,父島,2089,16,1159,8,930,8,1119
13421001001,小笠原支庁小笠原村,父島字西町,159,0,80,0,79,0,98
13421001002,小笠原支庁小笠原村,父島字宮之浜道,146,1,88,1,58,0,77
13421001003,小笠原支庁小笠原村,父島字東町,170,4,92,0,78,4,113
13421001004,小笠原支庁小笠原村,父島字大根山,27,0,27,0,0,0,2
13421001005,小笠原支庁小笠原村,父島字清瀬,845,8,449,5,396,3,409
13421001006,小笠原支庁小笠原村,父島字奥村,549,3,313,2,236,1,311
13421001008,小笠原支庁小笠原村,父島字三日月山,0,0,0,0,0,0,0
13421001009,小笠原支庁小笠原村,父島字船見山,0,0,0,0,0,0,0
13421001010,小笠原支庁小笠原村,父島字宮之浜,0,0,0,0,0,0,0
13421001011,小笠原支庁小笠原村,父島字釣浜,0,0,0,0,0,0,0
13421001012,小笠原支庁小笠原村,父島字屏風谷,0,0,0,0,0,0,0
13421001013,小笠原支庁小笠原村,父島字旭山,0,0,0,0,0,0,0
13421001014,小笠原支庁小笠原村,父島字境浦,3,X,0,X,3,X,2
13421001015,小笠原支庁小笠原村,父島字夜明山,0,0,0,0,0,0,0
13421001016,小笠原支庁小笠原村,父島字初寝浦,0,0,0,0,0,0,0
13421001017,小笠原支庁小笠原村,父島字吹上谷,8,0,5,0,3,0,4
13421001018,小笠原支庁小笠原村,父島字扇浦,59,0,35,0,24,0,34
13421001019,小笠原支庁小笠原村,父島字桑ノ木山,0,0,0,0,0,0,0
13421001020,小笠原支庁小笠原村,父島字洲崎,0,0,0,0,0,0,0
13421001021,小笠原支庁小笠原村,父島字二子,3,X,3,X,0,X,3
13421001022,小笠原支庁小笠原村,父島字小曲,100,0,56,0,44,0,56
13421001023,小笠原支庁小笠原村,父島字長谷,4,X,3,X,1,X,3
13421001024,小笠原支庁小笠原村,父島字大滝,0,0,0,0,0,0,0
13421001025,小笠原支庁小笠原村,父島字東海岸,0,0,0,0,0,0,0
13421001026,小笠原支庁小笠原村,父島字時雨山,0,0,0,0,0,0,0
13421001027,小笠原支庁小笠原村,父島字北袋沢,16,0,8,0,8,0,7
13421001028,小笠原支庁小笠原村,父島字南袋沢,0,0,0,0,0,0,0
13421001029,小笠原支庁小笠原村,父島字巽谷,0,0,0,0,0,0,0
13421001030,小笠原支庁小笠原村,父島字西海岸,0,0,0,0,0,0,0
13421001031,小笠原支庁小笠原村,父島字兄島,0,0,0,0,0,0,0
13421001032,小笠原支庁小笠原村,父島字弟島,0,0,0,0,0,0,0
13421001033,小笠原支庁小笠原村,父島字西之島,0,0,0,0,0,0,0
134210020,小笠原支庁小笠原村,母島,461,2,262,1,199,1,266
13421002001,小笠原支庁小笠原村,母島字元地,384,1,218,1,166,0,210
13421002003,小笠原支庁小笠原村,母島字西台,0,0,0,0,0,0,0
13421002004,小笠原支庁小笠原村,母島字東台,0,0,0,0,0,0,0
13421002005,小笠原支庁小笠原村,母島字衣舘,0,0,0,0,0,0,0
13421002006,小笠原支庁小笠原村,母島字庚申塚,0,0,0,0,0,0,0
13421002007,小笠原支庁小笠原村,母島字長浜,0,0,0,0,0,0,0
13421002008,小笠原支庁小笠原村,母島字石門,0,0,0,0,0,0,0
13421002009,小笠原支庁小笠原村,母島字猪熊谷,0,0,0,0,0,0,0
13421002010,小笠原支庁小笠原村,母島字西浦,0,0,0,0,0,0,0
13421002011,小笠原支庁小笠原村,母島蝙蝠谷,0,0,0,0,0,0,0
13421002012,小笠原支庁小笠原村,母島字大谷,10,X,10,X,0,X,10
13421002013,小笠原支庁小笠原村,母島字船見台,0,0,0,0,0,0,0
13421002014,小笠原支庁小笠原村,母島字船木山,8,X,5,X,3,X,5
13421002015,小笠原支庁小笠原村,母島字東崎,0,0,0,0,0,0,0
13421002016,小笠原支庁小笠原村,母島字静沢,58,1,28,0,30,1,40
13421002017,小笠原支庁小笠原村,母島字評議平,0,0,0,0,0,0,0
13421002018,小笠原支庁小笠原村,母島字中ノ平,1,X,1,X,0,X,1
13421002019,小笠原支庁小笠原村,母島字南崎,0,0,0,0,0,0,0
13421002020,小笠原支庁小笠原村,母島,0,0,0,0,0,0,0
134210030,小笠原支庁小笠原村,聟島,0,0,0,0,0,0,0
134210040,小笠原支庁小笠原村,硫黄島,401,0,401,0,0,0,70
13421004001,小笠原支庁小笠原村,硫黄島字北硫黄島,0,0,0,0,0,0,0
13421004002,小笠原支庁小笠原村,硫黄島,401,0,401,0,0,0,70
13421004003,小笠原支庁小笠原村,硫黄島字南硫黄島,0,0,0,0,0,0,0
134210050,小笠原支庁小笠原村,沖ノ鳥島,0,0,0,0,0,0,0
134210060,小笠原支庁小笠原村,南鳥島,71,0,71,0,0,0,62
